pa	pa	夫玞砆鳺																							
paʔ	paq	斧鈇蚥甫{男子美稱；大；開始}簠黼脯㕮																							
pah	pah	賦																							
pʰa	pha	敷																							
pʰaʔ	phaq	撫俌																							
ba	ba	夫扶芙枎榑																							
baʔ	baq	父釜滏輔鬴																							
bah	bah	賻																							
ma	ma	無无蕪譕巫誣莁亡																							
maʔ	maq	武鵡舞潕廡甒儛膴{美厚}憮{悵然失意}毋𢜮																							
m̥aʔ	mhaq	鄦許{姓}冔																							
ta	ta	諸櫧遮																							
taʔ	taq	渚陼煑煮䰞褚{囊袋}者赭																							
tah	tah	翥柘蔗																							
sta	sta	書																							
staʔ	staq	緒																							
stah	stah	庶																							
tʰaʔ	thaq	處杵																							
tʰah	thah	厈䞣																							
stʰaʔ	sthaq	暑																							
stʰa	stha	奢奓																							
da	da	蜍{蟾~}																							
daʔ	daq	社																							
dah	dah	署曙藷薯																							
na	na	如茹{根；~藘，茜草}𩶯鴽																							
naʔ	naq	汝茹{喫}																							
nah	nah	茹{柔軟；猜度}洳{沮~：低濕之地}𣹤																							
n̥ah	nhah	恕赦																							
snah	snah	絮{粗絲綿}																							
tsa	tsa	且{多；也~；紀月地支；專名}苴{鞋中草墊}蛆䪶罝																							
tsaʔ	tsaq	咀飷																							
tsah	tsah	沮{~洳：低濕之地}唶借{~出；假如}																							
tsʰa	tsha	沮{河名}狙砠疽雎鴡																							
tsʰaʔ	tshaq	且																							
dza	dza	豠																							
dzaʔ	dzaq	沮{阻止；毀壞；恐懼}																							
sa	sa	胥蝑																							
saʔ	saq	湑諝糈稰胥{才智；小官}																							
la	la	余餘畬雓狳伃妤																							
laʔ	laq	予野壄																							
lah	lah	豫{安樂、喜悅}預悆射{~干，木名}																							
l̥a	lha	舒賒																							
l̥aʔ	lhaq	鼠癙黍舍{~棄；赦免；施~}騇																							
l̥ah	lhah	舍舎捨																							
slaʔ	slaq	寫序{廂房；學校}敘{次序；記~}漵紓																							
sla	sla	徐																							
slah	slah	榭謝㴬																							
mlaʔ	mlaq	墅野{東漢中原方言}抒																							
mlah	mlah	射䠶																							
ra	ra	慮藘廬驢																							
raʔ	raq	旅膂呂侶																							
rah	rah	勴濾																							
C.ra	C.ra	閭臚																							
C.raʔ	C.raq	儢																							
ɫa	ja	輿譽{動詞}璵旟歟𪋮耶瑘琊鎁鋣																							
ɫaʔ	jaq	與也冶																							
ɫah	jah	譽鸒{~斯，鳥名}礜藇{藷~}蕷豫{猶~}夜射{僕~、~姑}鵺																							
ɫ̥a	jha	車																							
kɫaʔ	kjaq	舉																							
mɫa	mja	邪{不正}衺斜																							
mɫaʔ	mjaq	藇{酒美}鱮																							
ka	ka	車居琚裾倨据崌鶋凥																							
kaʔ	kaq	柜矩榘萭																							
kah	kah	椐鋸踞據																							
kʰa	kha	墟祛袪阹魼																							
kʰaʔ	khaq	紶麮																							
kʰah	khah	去呿鼁																							
ga	ga	渠蕖腒懅籧蘧																							
gaʔ	gaq	巨蚷姖鉅拒詎秬岠苣歫距炬虡簴鐻																							
gah	gah	遽豦醵																							
ŋa	nga	魚漁																							
ŋaʔ	ngaq	語圉圄禦篽敔鋙																							
ŋah	ngah	御馭																							
ŋ̊aʔ	nhgaq	許																							
ha	ha	虛噓魖𧴆歔𨼋																							
haʔ	haq	所{~~}許{~~}																							
kwa	kwa	𥇛㪺																							
kwaʔ	kwaq	蝺楀																							
kʰwaʔ	khwaq	踽齲																							
gwa	gwa	瞿衢躣鸜																							
ŋwa	ngwa	虞澞娛																							
ŋwaʔ	ngwaq	俁{~~，大}噳{~~，多}麌																							
wa	wa	于竽玗盂雩謣邘迂杅																							
waʔ	waq	雨羽宇禹鄅偊																							
wah	wah	芋																							
ẘa	wha	吁盱荂																							
ẘaʔ	whaq	栩詡訏																							
ʔa	qa	於淤																							
ʔah	qah	菸𡌧棜瘀																							
ʔwa	qwa	紆陓																							
pra	pra	膚																							
praʔ	praq	甫{國名}																							
prah	prah	傅																							
tra	tra	豬潴瀦																							
traʔ	traq	貯褚{棺飾}																							
trah	trah	著{顯著；成就；記載}箸咤																							
tʰra	thra	㻬㯉樗																							
tʰraʔ	thraq	楮																							
dra	dra	躇藸																							
draʔ	draq	儲宁佇杼羜紵芧竚䇡																							
nra	nra	挐蒘袽帤																							
nraʔ	nraq	女籹																							
n̥ra	nhra	筡絮{調味}																							
tsra	tsra	菹葅																							
tsraʔ	tsraq	阻俎助																							
tsrah	tsrah	詛																							
tsʰra	tshra	初																							
tsʰraʔ	tshraq	楚濋																							
dzra	dzra	苴{麻子}鋤耡鉏																							
dzrah	dzrah	麆																							
sra	sra	疋疏疎踈梳蔬																							
lra	lra	除篨蒢																							
r̥a	rha	攄																							
kraʔ	kraq	莒筥																							
graʔ	graq	粔																							
ŋ̊raʔ	nhgraq	所																							
pˤa	p'a	逋餔晡																							
pˤaʔ	p'aq	圃甫{園；茂盛}補																							
pˤah	p'ah	布																							
pʰˤa	ph'a	鋪痡																							
pʰˤaʔ	ph'aq	浦溥普																							
pʰˤah	ph'ah	怖																							
bˤa	b'a	蒲莆匍酺																							
bˤaʔ	b'aq	簿蓴																							
bˤah	b'ah	步薄{動詞}捕哺																							
mˤa	m'a	謨摹摸模嫫𡠜膜{~拜}																							
mˤaʔ	m'aq	莽{草叢；茂盛}募																							
mˤah	m'ah	莫{暮；晚}暮慕墓慔																							
m̥ˤa	mh'a	膴{無骨的干肉}幠憮{大、粗}																							
tˤa	t'a	都闍																							
tˤaʔ	t'aq	覩睹堵帾楮																							
tˤah	t'ah	妬妒秅㓃																							
tʰˤaʔ	th'aq	土吐芏																							
dˤa	d'a	徒跿圖瘏屠																							
dˤaʔ	d'aq	杜																							
dˤah	d'ah	度渡																							
nˤa	n'a	奴砮帑孥駑																							
nˤaʔ	n'aq	弩怒																							
nˤah	n'ah	笯																							
tsˤa	ts'a	租蒩																							
tsˤaʔ	ts'aq	祖組																							
tsʰˤa	tsh'a	粗麤																							
tsʰˤaʔ	tsh'aq	蔖																							
tsʰˤah	tsh'ah	錯{同“措”}措醋																							
dzˤa	dz'a	徂殂虘																							
dzˤaʔ	dz'aq	駔																							
dzˤah	dz'ah	祚胙阼																							
sˤa	s'a	蘇{扶~；姑~；~~}																							
sˤah	s'ah	素嗉																							
lˤa	l'a	塗荼涂途蒤嵞鵌鷋駼鷵																							
lˤah	l'ah	斁{敗壞}																							
l̥ˤaʔ	lh'aq	稌																							
l̥ˤah	lh'ah	兔菟鵵																							
rˤa	r'a	盧蘆壚鸕鑪爐顱攎蠦櫨玈艫轤																							
rˤaʔ	r'aq	魯鹵滷蓾櫓虜																							
rˤah	r'ah	璐賂輅潞簬簵																							
C.rˤa	C.r'a	黸纑																							
C.rˤah	C.r'ah	路露鷺																							
kˤa	k'a	姑辜沽{買賣}鴣蛄橭嫴																							
kˤaʔ	k'aq	股羖古罟𦊟沽{粗劣}盬詁賈蠱																							
kˤah	k'ah	固故錮																							
kʰˤa	kh'a	枯軲																							
kʰˤaʔ	kh'aq	苦𩇵																							
kʰˤah	kh'ah	庫																							
gˤa	g'a	乎㝬胡瑚湖葫鶦鶘餬鬍魱沍																							
gˤaʔ	g'aq	岵怙祜酤楛芐																							
gˤah	g'ah	互枑嫮嫭																							
ŋˤa	ng'a	吾梧郚鼯																							
ŋˤaʔ	ng'aq	五伍午迕仵窰窹																							
ŋˤah	ng'ah	忤悟牾啎𠵦𧺴寤晤逜捂䎸遻																							
ŋ̊ˤa	nhg'a	蘇																							
ŋ̊ˤah	nhg'ah	愬訴泝溯遡𧪜																							
hˤa	h'a	呼虖嘑																							
hˤaʔ	h'aq	滸虎俿琥箎																							
hˤah	h'ah	謼																							
kwˤa	kw'a	孤觚軱呱泒菰苽罛																							
kwˤaʔ	kw'aq	鼓皷瞽顧{靡~、不~、弗~}																							
kwˤah	kw'ah	顧																							
kʰwˤa	khw'a	刳挎鮬																							
kʰwˤah	khw'ah	袴褲絝																							
gwˤa	gw'a	壺弧狐瓠																							
gwˤaʔ	gw'aq	户戶扈鳸																							
gwˤah	gw'ah	護擭韄䨼																							
ŋwˤa	ngw'a	吳𩶭																							
ŋwˤah	ngw'ah	誤悞																							
wˤaʔ	w'aq	雽																							
ʔˤa	q'a	於歍烏嗚污																							
ʔˤaʔ	q'aq	鄔隖																							
ʔˤah	q'ah	惡洿																							
ʔwˤa	qw'a	汙汚窏圬扜杇鴮																							
pˤra	p'ra	巴芭蚆豝鈀																							
pˤraʔ	p'raq	把																							
pˤrah	p'rah	霸																							
pʰˤra	ph'ra	葩																							
mˤra	m'ra	蟆𢋙䗫																							
mˤraʔ	m'raq	馬																							
mˤrah	m'rah	禡罵㾺鬕																							
tˤrah	t'rah	吒																							
tʰˤra	th'ra	譇																							
tʰˤrah	th'rah	侘詫																							
nˤra	n'ra	挐{同“拏”}拏																							
nˤraʔ	n'raq	䋈																							
tsˤra	ts'ra	抯柤樝																							
tsˤraʔ	ts'raq	苴{土~；木名}																							
tsˤrah	ts'rah	詐																							
dzˤra	dz'ra	苴{枯草}楂																							
dzˤrah	dz'rah	乍																							
lˤra	l'ra	茶																							
kˤra	k'ra	葭豭猳家犌麚																							
kˤraʔ	k'raq	假椵瘕榎賈{國名、姓}檟斝嘏																							
kˤrah	k'rah	稼嫁價																							
kʰˤra	kh'ra	加{膠~，乖戾}																							
gˤra	g'ra	遐霞瑕䪗蕸騢鰕																							
gˤraʔ	g'raq	夏下暇廈																							
ŋˤra	ng'ra	牙芽衙																							
ŋˤraʔ	ng'raq	雅庌																							
ŋˤrah	ng'rah	迓訝																							
hˤrah	h'rah	嚇罅㙤煆																							
kwˤra	kw'ra	瓜																							
kwˤraʔ	kw'raq	寡																							
kʰwˤra	khw'ra	夸姱跨誇																							
gwˤrah	gw'rah	懼槬																							
wˤra	w'ra	華嘩驊釫																							
ẘˤra	wh'ra	花譁																							
ʔˤra	q'ra	鴉𢵣																							
ʔˤraʔ	q'raq	啞																							
ʔˤrah	q'rah	亞啞{表驚歎}㰳																							
paŋ	pang	方枋牥汸肪鈁邡{什~}																							
paŋʔ	pangq	放昉旊舫方																							
pʰaŋ	phang	芳妨																							
pʰaŋʔ	phangq	仿紡髣{~髴，隱約}彷{~彿，隱約}鶭																							
pʰaŋh	phangh	訪邡																							
baŋ	bang	房防坊{同“防”}魴																							
bak	bak	縛𦇙																							
maŋ	mang	亡亾忘妄望朢罔惘芒{~~，廣大遼闊；句~，木神}莣杗																							
maŋʔ	mangq	網𦉾蝄𣶈{~瀁，水盛貌}輞																							
taŋ	tang	章彰漳璋障樟獐鄣																							
taŋʔ	tangq	掌																							
tak	tak	蹠摭炙跖斫																							
staŋ	stang	商螪蔏																							
staŋʔ	stangq	賞																							
tʰaŋ	thang	昌倡唱猖菖閶																							
tʰaŋʔ	thangq	敞惝𪁺																							
tʰak	thak	斥尺蚇拆叱																							
daŋ	dang	常裳徜嘗甞償鱨																							
daŋʔ	dangq	上																							
daŋh	dangh	尚																							
dak	dak	石祏碩鼫																							
naŋ	nang	攘穰瀼禳讓鬤儴𨟚鑲																							
naŋʔ	nangq	壤蠰{~谿}																							
naŋh	nangh	懹																							
nak	nak	若鄀箬																							
n̥aŋʔ	nhangq	曏																							
n̥aŋh	nhangh	蠰																							
n̥ak	nhak	螫																							
snaŋ	snang	襄驤纕																							
tsaŋ	tsang	將漿醬蔣																							
tsaŋʔ	tsangq	獎槳																							
tsak	tsak	踖{~~，恭敬}借{~入}																							
tsʰaŋ	tshang	將{願、請；~~，擬聲詞，金玉之聲；~~，美盛、整飭；集聚貌}斨鏘瑲槍蹌搶牄																							
tsʰak	tshak	鵲䧿踖{~陵，地名}碏皵																							
dzaŋ	dzang	戕牆薔{同“蘠”}蘠嬙廧																							
dzaŋh	dzangh	匠																							
dzak	dzak	籍藉猎踖耤																							
saŋ	sang	相湘箱廂																							
saŋʔ	sangq	想																							
sak	sak	昔惜腊棤																							
laŋ	lang	昜陽楊揚瘍煬鍚颺暘鸉																							
lak	lak	睪譯繹嶧懌斁{厭棄；盛大}驛射{厭棄；無~}奕{~~，美盛}																							
l̥aŋ	lhang	傷觴殤禓䵮																							
l̥aŋh	lhangh	餉饟																							
l̥ak	lhak	釋郝{~~，耕地翻土聲}醳𥼶奭襫																							
slak	slak	舄蕮潟																							
slaŋʔ	slangq	象像蟓																							
mlak	mlak	射{及物}麝																							
raŋ	rang	良踉蜋{蜣~、~蜩}梁粱量糧輬椋娘																							
raŋʔ	rangq	兩蜽輛緉悢																							
rak	rak	略㗉																							
C.raŋ	C.rang	涼																							
C.raŋh	C.rangh	亮諒																							
C.rak	C.rak	掠																							
ɫaŋ	jang	羊洋徉佯痒恙羕																							
ɫaŋʔ	jangq	養瀁{𣶈~，水盛貌}癢																							
ɫaŋh	jangh	漾																							
ɫak	jak	亦奕弈帟腋掖液																							
ɫ̥ak	jhak	赤																							
kɫaŋ	kjang	姜𨜰																							
kʰɫaŋ	khjang	羌																							
mɫaŋ	mjang	詳祥翔𦍙𨀘庠𦍲																							
mɫaŋʔ	mjangq	橡																							
mɫak	mjak	夕汐穸																							
kaŋ	kang	畺僵疆薑橿繮																							
kaŋʔ	kangq	繈襁																							
kak	kak	腳																							
kʰaŋ	khang	蜣																							
kʰak	khak	卻却																							
gaŋ	gang	強彊强																							
ŋaŋʔ	ngangq	仰																							
haŋ	hang	向享鄉饗薌膷香																							
haŋʔ	hangq	響蠁{肸~}嚮																							
kwaŋʔ	kwangq	獷																							
kwaŋh	kwangh	誑迋{同“誑”}																							
kwak	kwak	矍攫玃貜																							
kʰwaŋ	khwang	匡筐眶																							
kʰwak	khwak	躩																							
gwaŋ	gwang	狂																							
gwaŋʔ	gwangq	俇																							
gwak	gwak	戄臞																							
waŋ	wang	王																							
waŋʔ	wangq	往																							
waŋh	wangh	迋{同“往”}暀旺																							
ẘaŋ	whang	貺																							
ẘaŋʔ	whangq	怳																							
ẘaŋh	whangh	況軦																							
ʔaŋ	qang	央殃																							
ʔaŋʔ	qangq	怏佒鞅駚柍																							
ʔwaŋʔ	qwangq	枉																							
ʔwak	qwak	矱																							
praŋ	prang	兵柄																							
praŋʔ	prangq	丙炳怲邴𠛥秉																							
praŋh	prangh	寎																							
prak	prak	碧																							
braŋh	brangh	病																							
mraŋ	mrang	明盟																							
mraŋʔ	mrangq	皿																							
traŋ	trang	張粻餦																							
traŋʔ	trangq	長{年~；生~}																							
traŋh	trangh	脹帳																							
trak	trak	著{接觸；殷商酒器}𣃈𩁥鐯席																							
tʰraŋ	thrang	倀																							
tʰraŋʔ	thrangq	悵																							
tʰraŋh	thrangh	韔																							
tʰrak	thrak	躇{超越}																							
draŋ	drang	長{~久；擅~；~處}萇																							
draŋʔ	drangq	丈杖仗																							
drak	drak	蓆																							
nraŋ	nrang	鑲{兵器}																							
nraŋh	nrangh	釀																							
n̥rak	nhrak	婼																							
tsraŋ	tsrang	壯𢎳莊裝																							
tsrak	tsrak	斮																							
tsʰraŋ	tshrang	創瘡																							
tsʰraŋʔ	tshrangq	愴																							
tsʰrak	tshrak	簎																							
dzraŋ	dzrang	牀床																							
dzraŋh	dzrangh	狀																							
sraŋ	srang	霜爽鷞鸘																							
lraŋ	lrang	場腸																							
l̥raŋh	lhrangh	暢鬯畼																							
l̥rak	lhrak	㚟																							
srak	srak	虩覤																							
kraŋ	krang	京麖竟鏡境麠																							
kraŋʔ	krangq	景																							
krak	krak	戟																							
kʰrak	khrak	綌郤郄隙隟𢜭																							
graŋ	grang	鯨勍黥																							
graŋʔ	grangq	競																							
graŋh	grangh	倞																							
grak	grak	劇臄																							
ŋraŋ	ngrang	迎																							
ŋrak	ngrak	逆																							
ŋ̊rak	nhgrak	朔																							
kwraŋʔ	kwrangq	憬囧冏臩																							
wraŋʔ	wrangq	永泳𢫕																							
wraŋh	wrangh	詠咏																							
ẘraŋ	whrang	兄																							
ʔraŋ	qrang	英																							
ʔraŋʔ	qrangq	影																							
ʔraŋh	qrangh	詇																							
pˤaŋh	p'angh	謗																							
pˤak	p'ak	博簙搏鎛猼髆																							
pʰˤaŋ	ph'ang	旁{~薄}滂雱																							
pʰˤak	ph'ak	蒪膊胉																							
bˤaŋ	b'ang	旁傍膀彭{~~，盛多}彷{~徉、~徨}																							
bˤaŋh	b'angh	徬																							
bˤak	b'ak	薄亳泊礡鑮																							
mˤaŋ	m'ang	芒盲肓㡛蘉汒茫																							
mˤaŋʔ	m'angq	莽{無邊際}漭蟒																							
mˤak	m'ak	莫漠幕寞嗼瘼鏌瞙鄚																							
m̥ˤaŋ	mh'ang	荒衁																							
m̥ˤaŋʔ	mh'angq	謊慌怳恍𡧽																							
tˤaŋ	t'ang	當蟷璫																							
tˤaŋʔ	t'angq	黨																							
tˤaŋh	t'angh	擋瓽																							
tˤak	t'ak	蠹																							
tʰˤaŋ	th'ang	鏜蝪																							
tʰˤaŋʔ	th'angq	儻倘曭																							
tʰˤak	th'ak	託拓托柝橐																							
dˤaŋ	d'ang	堂棠螗螳																							
dˤaŋh	d'angh	宕																							
dˤak	d'ak	度{測量（動詞）；揣測；裝填}剫																							
nˤaŋ	n'ang	囊蠰{蟷~}																							
nˤaŋʔ	n'angq	曩																							
nˤak	n'ak	諾																							
n̥ˤak	nh'ak	蠚																							
tsˤaŋ	ts'ang	牂臧贓葬																							
tsˤak	ts'ak	作迮柞																							
tsʰˤaŋ	tsh'ang	倉蒼凔滄鶬獊鎗																							
tsʰˤak	tsh'ak	錯厝剒																							
dzˤaŋ	dz'ang	藏臟奘																							
dzˤak	dz'ak	怍酢昨柞{~格}笮{黥刑}筰㸲𦁎䣢																							
sˤaŋ	s'ang	桑喪顙																							
sˤak	s'ak	索溹																							
lˤaŋ	l'ang	唐塘鶶榶溏愓餳																							
lˤaŋʔ	l'angq	璗蕩盪簜𥯕																							
lˤaŋh	l'angh	碭																							
lˤak	l'ak	鐸																							
l̥ˤaŋ	lh'ang	湯薚																							
l̥ˤak	lh'ak	蘀																							
rˤaŋ	r'ang	郎朗廊狼浪琅稂閬𦵧駺蜋{螳~}螂																							
rˤaŋʔ	r'angq	朖俍																							
rˤaŋh	r'angh	埌																							
rˤak	r'ak	洛酪雒駱絡鵅{水鳥名}烙硌鮥𩊚袼珞																							
C.rˤak	C.r'ak	落																							
hɫˤak	hj'ak	郝																							
kˤaŋ	k'ang	亢岡剛綱犅堈崗𦱌魧																							
kˤak	k'ak	各閣胳																							
kʰˤaŋ	kh'ang	康糠穅伉漮																							
kʰˤaŋʔ	kh'angq	慷忼																							
kʰˤaŋh	kh'angh	炕閌犺																							
kʰˤak	kh'ak	恪																							
gˤaŋ	g'ang	行頏杭抗桁{刑具}笐迒苀蚢胻航																							
gˤaŋʔ	g'angq	沆																							
gˤak	g'ak	涸貉狢貈																							
ŋˤaŋ	ng'ang	卬昂枊																							
ŋˤak	ng'ak	咢鄂噩蘁愕鍔鶚遌																							
hˤak	h'ak	壑																							
kwˤaŋ	kw'ang	光洸胱桄珖茪																							
kwˤaŋʔ	kw'angq	廣																							
kwˤak	kw'ak	郭椁槨																							
kʰwˤaŋ	khw'ang	曠																							
kʰwˤaŋʔ	khw'angq	懭																							
kʰwˤaŋh	khw'angh	壙纊絖																							
kʰwˤak	khw'ak	廓鞹鞟漷篧																							
gwˤaŋ	gw'ang	黃簧璜																							
gwˤaŋʔ	gw'angq	櫎																							
gwˤaŋh	gw'angh	擴																							
gwˤak	gw'ak	檴{~落}濩穫鑊																							
ŋwˤak	ngw'ak	瓁																							
wˤaŋ	w'ang	皇凰煌熿遑韹餭徨惶媓湟蝗葟騜隍𦨃篁偟蟥																							
ẘˤak	wh'ak	霍藿𧆑靃																							
ʔˤaŋ	q'ang	鴦																							
ʔˤaŋʔ	q'angq	泱盎坱																							
ʔˤaŋh	q'angh	㼜																							
ʔˤak	q'ak	堊蝁																							
ʔwˤaŋ	qw'ang	尢尪汪																							
ʔwˤak	qw'ak	蠖雘																							
pˤraŋ	p'rang	祊閍旁{~~，強壯有力}																							
pˤraŋh	p'rangh	榜{槳}																							
pˤrak	p'rak	百伯柏迫																							
pʰˤraŋ	ph'rang	亨烹																							
pʰˤrak	ph'rak	魄拍																							
bˤraŋ	b'rang	彭{~~，強壯}蒡榜{矯正弓弩的器具}																							
bˤraŋʔ	b'rangq	並竝																							
bˤrak	b'rak	白帛鮊																							
mˤraŋ	m'rang	萌{芽}氓虻蝱䖟鄳莔																							
mˤraŋʔ	m'rangq	猛																							
mˤraŋh	m'rangh	孟																							
mˤrak	m'rak	陌貘貊𢫦																							
tˤrak	t'rak	磔																							
tʰˤraŋ	th'rang	瞠																							
tʰˤrak	th'rak	坼																							
dˤraŋ	d'rang	棖䟫																							
dˤrak	d'rak	宅																							
tsˤrak	ts'rak	笮{盛箭的竹器}窄柞{伐木}矠																							
tsʰˤraŋ	tsh'rang	槍{欃~，彗星}																							
dzˤraŋ	dz'rang	傖																							
dzˤrak	dz'rak	咋齰蜡																							
sˤrak	s'rak	索																							
lˤrak	l'rak	擇澤檡鸅蠌																							
kˤraŋ	k'rang	庚更羹賡鶊																							
kˤraŋʔ	k'rangq	梗鯁綆哽郠埂																							
kˤrak	k'rak	格茖鉻骼鵅{鵋䳢、鵂鶹}觡挌																							
kʰˤraŋ	kh'rang	慶卿阬坑																							
kʰˤrak	kh'rak	客喀衉																							
gˤraŋ	g'rang	行珩衡蘅桁{葬具}																							
gˤraŋʔ	g'rangq	荇杏莕																							
gˤrak	g'rak	格{抵禦；捍~，堅硬}																							
ŋˤrak	ng'rak	額頟詻																							
hˤraŋ	h'rang	亨																							
hˤrak	h'rak	赫																							
kwˤraŋ	kw'rang	觥觵																							
kwˤraŋʔ	kw'rangq	礦穬																							
kwˤrak	kw'rak	虢																							
gwˤraŋ	gw'rang	橫潢																							
gwˤrak	gw'rak	獲																							
wˤraŋ	w'rang	喤鍠																							
ẘˤraŋ	wh'rang	諻																							
ẘˤrak	wh'rak	謋																							
ʔˤrak	q'rak	啞{~~，笑聲}																							
paj	paj	陂																							
pajʔ	pajq	彼柀																							
pajh	pajh	詖貱陂{斜}																							
pas	pas	廢櫠																							
pʰaj	phaj	披鈹秛																							
pʰas	phas	肺㤄{~~，輕慢}																							
baj	baj	皮被																							
bajh	bajh	鞁																							
bas	bas	茷																							
maj	maj	靡{共有；分散；損壞；浪費；~~，遲緩}攠縻糜䊳㸏爢																							
majʔ	majq	靡{倒伏；細密；無、非}蘼																							
m̥aj	mhaj	麾																							
tas	tas	晢晣晰抴																							
tʰaj	thaj	眵																							
tʰajʔ	thajq	侈{奢~}袲																							
tʰas	thas	懘																							
dajʔ	dajq	恀																							
das	das	逝筮噬澨遾																							
tsaj	tsaj	嗟𨲠																							
tsas	tsas	際穄																							
dzajh	dzajh	髊																							
sajʔ	sajq	徙蓰																							
laj	laj	迆杝柂栘箷椸酏胣釶																							
lajʔ	lajq	扡迤袘匜																							
lajh	lajh	貤																							
las	las	裔枻栧靾泄{~~，遲緩；多言}洩呭詍跇絏𢘽																							
l̥aj	lhaj	施葹䗐																							
l̥ajʔ	lhajq	豕𨴯弛㢮阤																							
l̥as	lhas	世貰																							
slas	slas	泄																							
mlaj	mlaj	蛇虵																							
mlajʔ	mlajq	𤜣																							
raj	raj	離鸝蘺籬漓縭罹																							
rajʔ	rajq	邐																							
rajh	rajh	詈																							
ras	ras	例勵癘櫔𩢾䅀																							
C.ras	C.ras	厲礪																							
ɫaj	jaj	移迻𤝻簃																							
ɫajʔ	jajq	拸																							
ɫas	jas	㵝{溶~}																							
ɫ̥ajʔ	jhajq	侈{大}哆鉹誃袳哆																							
kaj	kaj	奇{~偶；餘數；詭異不正}掎畸																							
kajʔ	kajq	踦剞																							
kajh	kajh	寄徛																							
kas	kas	罽瀱蘮																							
kʰaj	khaj	崎觭																							
kʰajʔ	khajq	綺																							
kʰas	khas	揭{~衣}																							
gaj	gaj	奇{稀~；窮~}錡騎琦鵸																							
ŋaj	ngaj	義儀轙議宜鸃																							
ŋajʔ	ngajq	蟻齮																							
ŋajh	ngajh	誼																							
ŋas	ngas	乂刈																							
ŋ̊aj	nhgaj	羲犧䖒戲																							
haj	haj	巇																							
kwaj	kwaj	嬀媯																							
kwas	kwas	𤜂																							
kʰwaj	khwaj	虧																							
ŋwaj	ngwaj	僞偽																							
waj	waj	爲為																							
wajʔ	wajq	蔿蒍薳寪鄬																							
ẘas	whas	歲顪																							
ẘaj	whaj	撝噅																							
ẘajʔ	whajq	毀毁毇𪑺燬烜{同“燬”，火}檓𡢕																							
ʔaj	qaj	椅猗欹旖漪禕																							
ʔajʔ	qajq	倚																							
ʔwaj	qwaj	蟡痿委{~蛇}逶蜲																							
ʔwajʔ	qwajq	骫																							
ʔwas	qwas	薉穢饖																							
praj	praj	羆藣																							
braj	braj	罷{同“疲”，疲勞；無能}犤疲																							
tʰras	thras	慸																							
dras	dras	滯																							
nraj	nraj	旎																							
nrajʔ	nrajq	狔																							
tsʰraj	tshraj	差杈																							
dzraj	dzraj	𨌅																							
srajʔ	srajq	屣縰躧蹝																							
lraj	lraj	池馳																							
lras	lras	彘{豬}																							
l̥ras	lhras	迣																							
r̥aj	rhaj	螭																							
sraj	sraj	醨釃																							
kraj	kraj	羈羇																							
kʰras	khras	憩愒{同“憩”}																							
kwras	kwras	劌																							
wras	wras	衛衞讆槥																							
ʔras	qras	餲																							
pˤaj	p'aj	波跛嶓																							
pˤajʔ	p'ajq	簸																							
pˤas	p'as	貝䰽㸬牬																							
pʰˤaj	ph'aj	頗																							
pʰˤajh	ph'ajh	破																							
pʰˤas	ph'as	霈																							
bˤaj	b'aj	婆																							
bˤas	b'as	旆肺{~~，茂盛}																							
mˤaj	m'aj	磨𨟖摩																							
mˤajʔ	m'ajq	麼																							
tˤaj	t'aj	多																							
tˤajh	t'ajh	跢																							
tˤas	t'as	帶																							
dˤaj	d'aj	𧕛																							
nˤaj	n'aj	那{安閑；奈何}難{茂盛}㔮																							
nˤas	n'as	奈柰																							
tsˤajʔ	ts'ajq	左																							
tsˤajh	ts'ajh	佐																							
tsʰˤaj	tsh'aj	磋																							
tsʰˤajʔ	tsh'ajq	瑳䰈																							
dzˤaj	dz'aj	蒫鹺齹䣜瘥																							
sˤaj	s'aj	莎娑{婆~，舞貌}傞																							
lˤaj	l'aj	沱紽佗酡𨠑鮀詑駝駞地陁{陂~，臺階}																							
lˤajʔ	l'ajq	拕袉																							
lˤas	l'as	大汏釱軑																							
l̥ˤaj	lh'aj	他它																							
l̥ˤajh	lh'ajh	拖																							
l̥ˤas	lh'as	泰汰太																							
rˤaj	r'aj	羅蘿																							
rˤas	r'as	籟藾																							
C.rˤas	C.r'as	賴瀨糲																							
kˤaj	k'aj	柯歌謌牱																							
kˤajʔ	k'ajq	哿笴																							
kˤajh	k'ajh	個个																							
kˤas	k'as	匄丐蓋葢																							
kʰˤajʔ	kh'ajq	可軻																							
kʰˤas	kh'as	礚愒{貪圖；荒廢}																							
gˤaj	g'aj	河何荷{~華}苛菏																							
gˤajʔ	g'ajq	荷{負~}																							
gˤajh	g'ajh	賀																							
gˤas	g'as	害																							
ŋˤaj	ng'aj	峨俄莪蛾娥鵝睋																							
ŋˤajʔ	ng'ajq	我																							
ŋˤajh	ng'ajh	餓																							
ŋˤas	ng'as	艾鴱																							
ŋ̊ˤas	nhg'as	餀𦤦																							
hˤaj	h'aj	訶呵																							
kwˤaj	kw'aj	過渦																							
kwˤajʔ	kw'ajq	剮																							
kwˤas	kw'as	膾會{總計；縫隙}檜旝廥鬠襘禬																							
kʰwˤaj	khw'aj	薖																							
gwˤajʔ	gw'ajq	禍旤																							
gwˤas	gw'as	繪會																							
ŋwˤaj	ngw'aj	吪訛譌																							
ŋwˤas	ngw'as	外																							
ẘˤaj	wh'aj	貨																							
ẘˤajʔ	wh'ajq	火{中古、《管子》“火”在此，或作“燬”“㷄”}																							
ẘˤas	wh'as	翽噦{~~，鈴聲、鳥聲；暗}																							
ʔˤaj	q'aj	阿妸妿																							
ʔˤas	q'as	藹																							
ʔwˤaj	qw'aj	濄																							
ʔwˤajh	qw'ajh	侉																							
ʔwˤas	qw'as	䵳																							
pˤrajʔ	p'rajq	擺																							
pˤras	p'ras	敗{破他}																							
bˤrajʔ	b'rajq	罷																							
bˤras	b'ras	敗{自破}																							
mˤraj	m'raj	麻犘䁲																							
mˤrajʔ	m'rajq	買																							
mˤrajh	m'rajh	賣																							
mˤras	m'ras	邁勱																							
tsʰˤraj	tsh'raj	艖																							
tsʰˤras	tsh'ras	蔡袃																							
dzˤrajʔ	dz'rajq	槎																							
dzˤrajh	dz'rajh	溠																							
sˤraj	s'raj	沙砂鯊																							
sˤras	s'ras	閷																							
kˤraj	k'raj	加枷耞珈痂嘉鴐茄																							
kˤrajh	k'rajh	駕																							
kˤras	k'ras	犗																							
kʰˤrajh	kh'rajh	疴																							
kwˤraj	kw'raj	蝸緺媧																							
kwˤras	kw'ras	獪																							
gwˤras	gw'ras	話																							
ŋwˤrajʔ	ngw'rajq	瓦																							
ẘˤraj	wh'raj	化																							
par	par	藩轓																							
parh	parh	賁{~卦}販																							
pʰar	phar	番翻																							
bar	bar	緐繁蕃燔璠繙蘩膰羳墦旛𪖇																							
tar	tar	觶																							
dzar	dzar	泉																							
kar	kar	建																							
gar	gar	乾騝{~~，健壯}																							
garh	garh	健																							
ŋar	ngar	巘																							
ŋ̊ar	nhgar	獻																							
har	har	憲																							
ŋwar	ngwar	原邍源																							
war	war	垣																							
warh	warh	院																							
ẘar	whar	宣瑄																							
pˤar	p'ar	番{~~，勇武}碆																							
pˤarh	p'arh	播																							
pʰˤar	ph'ar	潘																							
pʰˤarh	ph'arh	判{~渙，分散}																							
bˤar	b'ar	蟠皤{白}磻																							
tˤar	t'ar	單																							
tˤarʔ	t'arq	觛																							
tʰˤar	th'ar	嘽																							
dˤar	d'ar	鼉𪓽鼍驒																							
nˤar	n'ar	那{多}難																							
nˤarʔ	n'arq	儺																							
n̥ˤar	nh'ar	灘歎嘆																							
n̥ˤarh	nh'arh	漢																							
kˤar	k'ar	乾{~燥；竭盡}漧																							
kˤarʔ	k'arq	皯																							
kˤarh	k'arh	幹榦																							
kʰˤarh	kh'arh	看																							
gˤar	g'ar	翰{羽翼；輔佐}																							
ŋ̊ˤar	nhg'ar	獻{濾酒方法；周代雕飾的禮器}																							
ẘˤar	wh'ar	歡																							
ẘˤarh	wh'arh	渙{分散；判~，分散}																							
panʔ	panq	反返仮坂橎																							
panh	panh	畈																							
pat	pat	發撥																							
pʰan	phan	犿幡																							
pʰanh	phanh	嬎嬔㛯婏																							
ban	ban	樊蠜礬煩薠袢蹯𨆌皤{大；賁~}																							
bat	bat	罰藅伐瞂㕹墢																							
man	man	蔓																							
manʔ	manq	晚娩																							
manh	manh	萬万䡬																							
tan	tan	旃旜饘𥼷鸇氈																							
tanʔ	tanq	燀樿皽嫸																							
tanh	tanh	戰顫																							
tat	tat	浙																							
stan	stan	羶																							
tʰanʔ	thanq	闡幝譂灛繟嘽{舒緩}																							
dan	dan	蟬澶禪嬋																							
danʔ	danq	墠蟺善壇{廳堂；清除土地}																							
danh	danh	膳繕㪨鱔鱓䱇䱉擅																							
nan	nan	然燃																							
nanʔ	nanq	蹨熯{恭敬}																							
nat	nat	熱																							
tsanʔ	tsanq	錢{農具}帴																							
tsanh	tsanh	濺																							
tsʰan	tshan	遷																							
dzan	dzan	錢{~幣}																							
dzanʔ	dzanq	踐賤餞俴諓																							
san	san	僊仙鮮{水產；新鮮；鮮明}秈																							
sanʔ	sanq	鮮{少}尟癬廯																							
sanh	sanh	綫線絤																							
lan	lan	延蜒筵郔綖																							
lanʔ	lanq	𧊔																							
l̥an	lhan	埏扇煽傓																							
slat	slat	紲渫緤齥																							
slan	slan	涎																							
slanh	slanh	羨																							
mlan	mlan	鋋																							
mlat	mlat	舌揲{清點}																							
ran	ran	連漣㦁㶌																							
ranʔ	ranq	輦鄻																							
rat	rat	列{分裂}烈裂茢冽洌鮤鴷蛚																							
C.ran	C.ran	聯																							
C.ranʔ	C.ranq	璉																							
kan	kan	飦𩜾餰鞬犍腱																							
kanʔ	kanq	蹇搴攓藆																							
kat	kat	揭{舉；~露}羯桀{盛而高}訐																							
kʰat	khat	藒朅																							
gan	gan	赶																							
ganʔ	ganq	鍵楗揵寋																							
gat	gat	揭{~~，長}竭碣偈楬																							
ŋan	ngan	言																							
ŋanʔ	nganq	甗																							
ŋat	ngat	孽{~~，華麗}钀讞																							
ŋ̊at	nhgat	薛																							
han	han	軒掀鶱嘕																							
hanʔ	hanq	幰																							
hanh	hanh	𧾨																							
hat	hat	歇																							
kwat	kwat	厥撅蹶蹷																							
kʰwanʔ	khwanq	虇																							
kʰwanh	khwanh	勸																							
kʰwat	khwat	闕																							
gwat	gwat	橛																							
ŋwat	ngwat	月抈																							
wan	wan	援媛猨袁轅園榬猿爰蝯																							
wanʔ	wanq	遠																							
wanh	wanh	援{~助}																							
wat	wat	曰越鉞粵熭																							
ẘan	whan	讙{喧嘩}喧諠諼暖煖壎塤																							
ẘanʔ	whanq	咺烜{顯赫}																							
ẘanh	whanh	楥韗																							
ẘat	what	狘																							
ʔan	qan	焉蔫䗡																							
ʔanʔ	qanq	匽偃椻鰋鶠蝘																							
ʔanh	qanh	嫣																							
ʔat	qat	謁暍																							
ʔwan	qwan	蜿鵷																							
ʔwanʔ	qwanq	琬畹晼妴惌																							
ʔwat	qwat	噦{打嗝}																							
branh	branh	閞																							
mranʔ	mranq	勉免俛葂冕																							
tran	tran	邅鱣																							
tranʔ	tranq	展襢紾																							
tʰranʔ	thranq	蕆																							
tʰrat	thrat	硩																							
dran	dran	廛纏瀍躔鄽																							
dranʔ	dranq	紾																							
nranʔ	nranq	蹍跈																							
nranh	nranh	𨌑																							
tsranʔ	tsranq	醆琖																							
tsʰranʔ	tshranq	剗鏟羼																							
dzran	dzran	孱潺僝																							
dzranʔ	dzranq	棧䗃盞																							
sran	sran	山疝																							
srat	srat	殺煞榝鎩蔱																							
l̥ran	lhran	梴																							
l̥rat	lhrat	屮																							
kranʔ	kranq	謇																							
kʰran	khran	騫褰攐愆𢢈諐																							
gran	gran	虔榩騝																							
grat	grat	桀傑榤																							
ŋranh	ngranh	彥諺唁																							
ŋrat	ngrat	孽㜸糵蠥																							
ŋ̊ranʔ	nhgranq	產																							
kwrat	kwrat	鱖																							
gwran	gwran	權䑏蠸觠																							
wran	wran	圓湲																							
wranh	wranh	瑗褑																							
ʔran	qran	閼{~逢}																							
ʔranʔ	qranq	鄢																							
pˤanh	p'anh	半靽絆																							
pˤat	p'at	襏																							
pʰˤanh	ph'anh	泮畔判頖牉胖																							
bˤan	b'an	般{~遊；大}槃瘢搫柈蹣𪄀盤鞶縏媻幋磐																							
bˤanʔ	b'anq	拌																							
bˤanh	b'anh	伴叛																							
bˤat	b'at	茇軷魃																							
mˤan	m'an	曼漫謾墁槾鄤鏝瞞鞔																							
mˤanʔ	m'anq	滿																							
mˤanh	m'anh	縵幔悗浼{玷污}																							
mˤat	m'at	末沫秣韎妺粖𥽘																							
tˤan	t'an	丹鄲殫簞襌匰勯																							
tˤanʔ	t'anq	癉𤺺亶疸																							
tˤanh	t'anh	旦鴠																							
tˤat	t'at	怛妲䵣																							
tʰˤanʔ	th'anq	坦																							
dˤan	d'an	檀壇{高臺；地基}彈儃																							
dˤanʔ	d'anq	僤但袒潬																							
dˤanh	d'anh	憚																							
n̥ˤanʔ	nh'anq	熯{乾枯}暵																							
tsˤanh	ts'anh	贊賛𧄽灒																							
tsʰˤan	tsh'an	餐湌																							
tsʰˤanh	tsh'anh	粲																							
dzˤan	dz'an	戔{~~，堆積貌}殘㥇																							
dzˤanʔ	dz'anq	瓚																							
dzˤanh	dz'anh	囋																							
sˤan	s'an	珊跚姍𧽾																							
sˤanh	s'anh	散																							
sˤat	s'at	𥻦																							
lˤanʔ	l'anq	誕																							
lˤat	l'at	達																							
l̥ˤat	lh'at	達{放恣歡躍}闥撻																							
rˤan	r'an	瀾																							
rˤanʔ	r'anq	嬾																							
rˤanh	r'anh	糷灡																							
rˤat	r'at	剌瘌																							
C.rˤan	C.r'an	闌欄蘭																							
C.rˤanh	C.r'anh	爛																							
kˤan	k'an	干竿奸肝玕邗忓																							
kˤanʔ	k'anq	秆簳																							
kˤanh	k'anh	稈																							
kˤat	k'at	割葛																							
kʰˤan	kh'an	刊																							
kʰˤanʔ	kh'anq	侃衍																							
kʰˤanh	kh'anh	衎看																							
kʰˤat	kh'at	渴																							
gˤan	g'an	寒虷韓鶾雗翰{白（馬）}																							
gˤanʔ	g'anq	旱																							
gˤanh	g'anh	汗釬旰豻捍扞閈悍駻㪋螒矸																							
gˤat	g'at	曷褐鶡鳱毼𦼵蝎																							
ŋˤan	ng'an	犴																							
ŋˤanh	ng'anh	岸喭																							
ŋˤat	ng'at	蘖櫱枿																							
hˤanʔ	h'anq	罕䍐																							
hˤat	h'at	喝猲																							
kwˤan	kw'an	觀官倌																							
kwˤanʔ	kw'anq	管{~~，無所憑依}痯{~~，疲勞}錧																							
kwˤanh	kw'anh	雚瓘鸛爟鱹矔涫																							
kwˤat	kw'at	括适聒栝鴰髺萿																							
kʰwˤan	khw'an	寬																							
kʰwˤat	khw'at	闊{疏遠；寬~}																							
gwˤanh	gw'anh	逭																							
gwˤat	gw'at	活佸秳秮																							
wˤan	w'an	雈丸{小球；~~，高大挺直}芄紈桓貆峘荁豲洹																							
wˤanʔ	w'anq	緩萲																							
wˤanh	w'anh	換援𤴯																							
ẘˤan	wh'an	讙{傳說獸名；魯地名}酄驩獾貛懽𠂄鴅𩿊渙																							
ẘˤanh	wh'anh	奐𥈉㬇煥嚾喚																							
ẘˤat	wh'at	濊																							
ʔˤan	q'an	安鞍																							
ʔˤanh	q'anh	按案																							
ʔˤat	q'at	遏閼{遏制；單~}頞洝堨齃																							
ʔwˤan	qw'an	眢婠																							
ʔwˤanʔ	qw'anq	碗椀																							
ʔwˤanh	qw'anh	腕惋捥																							
ʔwˤat	qw'at	斡捾																							
pˤran	p'ran	般{~師}螌班斑頒肦																							
pˤranʔ	p'ranq	板版鈑																							
pʰˤran	ph'ran	攀扳眅																							
bˤranʔ	b'ranq	阪昄																							
mˤran	m'ran	獌																							
mˤranʔ	m'ranq	慢{緩~}																							
mˤranh	m'ranh	嫚慢{怠~；閒散}僈																							
tˤrat	t'rat	哳																							
nˤranʔ	n'ranq	赧戁																							
dzˤranʔ	dz'ranq	轏																							
sˤran	s'ran	删刪訕潸																							
sˤranh	s'ranh	汕																							
r̥ˤat	rh'at	蠆𧓽囆獺																							
kˤran	k'ran	姦菅葌蕑{蘭，一說菅}																							
kˤranʔ	k'ranq	諫																							
kˤranh	k'ranh	澗																							
kˤrat	k'rat	擖																							
gˤran	g'ran	閑{柵欄；保衛；大；嫻熟}睅																							
gˤranʔ	g'ranq	僩僴撊																							
gˤranh	g'ranh	骭																							
gˤrat	g'rat	舝轄鎋																							
ŋˤran	ng'ran	顔㘖																							
ŋˤranh	ng'ranh	鴈雁																							
ŋˤrat	ng'rat	齾																							
ŋ̊ˤranh	nhg'ranh	炭																							
kwˤrat	kw'rat	刮																							
gwˤranh	gw'ranh	宦																							
gwˤrat	gw'rat	姡																							
wˤran	w'ran	鍰																							
ʔˤranh	q'ranh	晏鴳鷃騴																							
ʔwˤranʔ	qw'ranq	綰																							
pap	pap	法																							
pʰamh	phamh	氾汎泛																							
bam	bam	凡帆																							
bamʔ	bamq	犯范範軓																							
bap	bap	乏																							
tam	tam	詹瞻																							
tʰam	tham	襜幨																							
tʰamh	thamh	裧䠨																							
dam	dam	蟾{~蜍}																							
damʔ	damq	贍																							
dap	dap	涉																							
nam	nam	髯呥袡柟{梅}																							
namʔ	namq	冉染苒媣																							
nap	nap	讘喦																							
n̥am	nham	㾆																							
tsam	tsam	漸鋟虃熸																							
tsap	tsap	接捷睫椄菨楫檝																							
tsʰamh	tshamh	塹																							
tsʰap	tshap	妾踥																							
dzamʔ	dzamq	蔪																							
sam	sam	纖																							
lam	lam	炎壛檐簷																							
lamʔ	lamq	剡琰棪𤟇掩{~埋}																							
lamh	lamh	豔艷焱燄																							
lap	lap	葉鍱揲{簸箕舌}																							
l̥amʔ	lhamq	陝𡟨覢																							
l̥amh	lhamh	煔掞																							
l̥ap	lhap	韘																							
slam	slam	爓燂燖燅																							
ram	ram	奩																							
ramʔ	ramq	蘞羷																							
ramh	ramh	殮獫																							
rap	rap	獵鬣躐犣擸																							
C.ramʔ	C.ramq	斂																							
ɫam	jam	鹽																							
kamʔ	kamq	檢																							
kamh	kamh	劍																							
kap	kap	劫袷跲衱																							
kʰamh	khamh	欠																							
kʰap	khap	怯胠																							
gam	gam	鉗鈐箝拑																							
gamʔ	gamq	儉芡																							
gap	gap	跲																							
ŋam	ngam	嚴																							
ŋamʔ	ngamq	隒儼顩																							
ŋamh	ngamh	驗																							
ŋap	ngap	業鄴																							
ŋ̊amʔ	nhgamq	玁																							
hamʔ	hamq	險嶮																							
hap	hap	脅嗋																							
wap	wap	曄燁爗饁																							
ʔam	qam	淹閹崦菴醃																							
ʔamʔ	qamq	奄黭{突然}掩{~匿}弇渰揜閹{~茂}																							
ʔap	qap	浥腌																							
pramh	pramh	窆																							
tʰramʔ	thramq	諂																							
nrap	nrap	聶躡欇																							
tsramʔ	tsramq	斬																							
tsʰrap	tshrap	臿插鍤疀扱㛼																							
dzram	dzram	毚讒儳巉																							
srap	srap	箑𥵳歃																							
tˤam	t'am	擔儋甔																							
tˤamʔ	t'amq	紞膽𪆻薝																							
tˤap	t'ap	譫																							
dˤamʔ	d'amq	憺																							
dˤamh	d'amh	澹																							
n̥ˤam	nh'am	聃																							
dzˤam	dz'am	慚慙																							
dzˤamh	dz'amh	暫蹔																							
lˤam	l'am	談惔㶣餤倓郯錟																							
lˤamʔ	l'amq	噉啖																							
lˤamh	l'amh	啗淡																							
lˤap	l'ap	闒蹋																							
l̥ˤamʔ	lh'amq	菼																							
l̥ˤap	lh'ap	鰈																							
rˤam	r'am	灆籃																							
rˤamʔ	r'amq	覽擥攬																							
rˤamh	r'amh	濫嚂㜮																							
rˤap	r'ap	臘																							
C.rˤam	C.r'am	藍																							
kˤam	k'am	甘泔柑																							
kˤamʔ	k'amq	敢																							
kˤap	k'ap	蓋																							
kʰˤamh	kh'amh	瞰闞																							
kʰˤap	kh'ap	榼																							
gˤam	g'am	邯酣甝																							
gˤamh	g'amh	矙																							
gˤap	g'ap	盍闔嗑																							
ŋˤamh	ng'amh	儑																							
hˤam	h'am	歛憨																							
ʔˤap	q'ap	𤸱																							
tsʰˤram	tsh'ram	欃																							
tsʰˤramh	tsh'ramh	摲																							
dzˤram	dz'ram	劖鑱																							
sˤram	s'ram	芟纔縿																							
sˤrap	s'rap	翣唼																							
kˤram	k'ram	監鑑礛																							
kˤramh	k'ramh	鑒																							
kˤrap	k'rap	甲																							
gˤram	g'ram	銜																							
gˤramʔ	g'ramq	檻壏㯺																							
gˤrap	g'rap	狎柙匣																							
ŋˤram	ng'ram	巖嵒																							
hˤrap	h'rap	嗑{笑聲}																							
ʔˤrap	q'rap	押																							
paw	paw	麃{耕耘；~~，勇武貌}鑣儦穮																							
pawʔ	pawq	表																							
bawʔ	bawq	藨																							
maw	maw	苗																							
taw	taw	昭鉊釗																							
tawh	tawh	照𨹸																							
tawk	tawk	炤																							
tʰaw	thaw	弨																							
tʰawk	thawk	綽婥																							
daw	daw	軺韶																							
dawh	dawh	邵劭卲																							
dawk	dawk	芍{~藥}																							
tsawʔ	tsawq	剿勦劋																							
tsʰawh	tshawh	峭																							
saw	saw	綃硝逍																							
sawh	sawh	肖鞘																							
law	law	䔄遙瑤謠謡鰩榣愮媱鷂𡺯姚																							
lawh	lawh	筄曜																							
lawk	lawk	藥濼蘥瀹鸙瀹																							
l̥awk	lhawk	爍鑠																							
l̥awh	lhawh	笑																							
raw	raw	燎																							
kaw	kaw	驕鷮憍簥蕎																							
kawʔ	kawq	矯敿撟蟜譑蹻{~~，強盛}																							
kawk	kawk	蹻屩																							
kʰaw	khaw	鞽趫																							
gaw	gaw	喬橋僑䱁毊嶠鐈轎																							
gawk	gawk	蹻{~~，驕慢；壯武}																							
ŋaw	ngaw	撓																							
ŋawk	ngawk	虐瘧																							
ŋ̊aw	nhgaw	囂䖀虈																							
ŋ̊awk	nhgawk	謔																							
haw	haw	枵呺歊藃獢																							
waw	waw	鴞																							
ʔaw	qaw	夭𡝩妖祅訞																							
ʔawʔ	qawq	殀																							
traw	traw	朝{~日；初始；日、天}																							
tʰraw	thraw	怊超																							
tʰrawk	thrawk	踔																							
draw	draw	朝潮晁																							
drawh	drawh	召																							
tsraw	tsraw	罺																							
dzraw	dzraw	巢																							
lrawʔ	lrawq	兆旐狣肇																							
pˤawk	p'awk	襮																							
bˤawh	b'awh	暴虣																							
bˤawk	b'awk	暴{曬、~露}曝																							
mˤaw	m'aw	毛旄																							
mˤawh	m'awh	眊																							
mˤawk	m'awk	耄芼																							
m̥ˤawh	mh'awh	秏耗																							
tˤaw	t'aw	刀忉																							
tˤawʔ	t'awq	倒																							
tˤawh	t'awh	到菿																							
tʰˤaw	th'aw	叨{~懫，暴戾}饕																							
dˤawk	d'awk	悼																							
tsˤawʔ	ts'awq	澡璪璅藻薻繰䲃繅																							
tsˤawh	ts'awh	躁趮																							
tsˤawk	ts'awk	糳鑿																							
tsʰˤaw	tsh'aw	操																							
tsʰˤawʔ	tsh'awq	懆																							
tsʰˤawh	tsh'awh	鄵																							
dzˤawk	dz'awk	鑿																							
sˤaw	s'aw	臊鱢																							
sˤawʔ	s'awq	燥																							
sˤawh	s'awh	噪譟																							
lˤaw	l'aw	桃逃洮{盥手；魯地名}駣咷鼗鞉鞀																							
lˤawh	l'awh	盜䌦																							
l̥ˤaw	lh'aw	滔{~~，大水奔流貌}挑洮{晉水名、曹地名}𠬢弢																							
rˤaw	r'aw	勞蟧																							
rˤawʔ	r'awq	潦澇橑䕩轑																							
rˤawk	r'awk	樂{歡~}轢犖𪇱濼{草名，貫衆}																							
kˤaw	k'aw	高膏																							
kˤawʔ	k'awq	縞槁槀稾稿藁杲																							
kʰˤawʔ	kh'awq	薧																							
kʰˤawh	kh'awh	犒																							
gˤaw	g'aw	號𨚙豪壕濠譹皜																							
gˤawʔ	g'awq	鎬滈薃鰝																							
gˤawh	g'awh	号																							
gˤawk	g'awk	鶴																							
ŋˤaw	ng'aw	敖嗸嗷遨蔜摮獒鷔熬鼇謷螯																							
ŋˤawh	ng'awh	敖{戲謔}傲慠驁奡鏊𢕟																							
ŋ̊ˤaw	nhg'aw	𠢕																							
hˤaw	h'aw	蒿毫																							
hˤawʔ	h'awq	傐																							
hˤawk	h'awk	熇謞嗃鄗{晉、趙地名；齊地名}臛																							
ʔˤawʔ	q'awq	芺䴠镺																							
ʔˤawk	q'awk	沃鋈																							
pˤrawk	p'rawk	駁駮嚗𦢊𪈚																							
bˤraw	b'raw	麃																							
bˤrawk	b'rawk	懪犦𤜌																							
mˤraw	m'raw	貓																							
mˤrawk	m'rawk	藐{茈草；~~，冷漠；盛美}																							
tˤrawh	t'rawh	罩鵫箌																							
tˤrawk	t'rawk	卓倬																							
tʰˤrawk	th'rawk	逴																							
dˤrawk	d'rawk	淖																							
sˤraw	s'raw	梢旓蛸艄																							
lˤrawk	l'rawk	濯{~~，光明、清朗、肥澤、光禿}																							
kˤraw	k'raw	交郊茭鮫蛟																							
kˤrawʔ	k'rawq	佼																							
kˤrawh	k'rawh	教																							
kˤrawk	k'rawk	較確																							
kʰˤraw	kh'raw	敲鄗{山名}																							
kʰˤrawk	kh'rawk	搉																							
gˤraw	g'raw	肴殽崤餚爻																							
gˤrawh	g'rawh	傚																							
gˤrawk	g'rawk	翯																							
ŋˤraw	ng'raw	磝																							
ŋˤrawk	ng'rawk	樂{音~}																							
hˤraw	h'raw	嚆																							
pe	pe	卑鵯																							
peʔ	peq	俾{使；從；~倪，城上短牆}髀																							
peh	peh	臂																							
pes	pes	蔽																							
pʰe	phe	䇑																							
pʰeʔ	pheq	吡庀疕																							
pʰeh	pheh	譬																							
be	be	埤脾裨蜱陴郫																							
beʔ	beq	庳婢																							
beh	beh	避																							
bes	bes	敝幣弊斃獘獙																							
me	me	彌																							
meʔ	meq	弭葞渳瀰芈羋䖹敉																							
te	te	禔祇{大；適，恰}																							
tes	tes	制製																							
steh	steh	翨啻																							
de	de	提軝																							
deʔ	deq	是氏諟																							
des	des	忕誓																							
ne	ne	唲{嚅~}																							
neʔ	neq	爾邇尒																							
n̥e	nhe	鸍																							
sneʔ	sneq	璽																							
tse	tse	訾貲髭觜䖪鄑𨚖㰣																							
tseʔ	tseq	紫茈訿呰																							
tses	tses	祭{~祀}																							
tsʰe	tshe	雌姕{~妓，婦女貌；一說婦女不美}																							
tsʰeʔ	tsheq	此泚跐𧺼																							
tsʰeh	tsheh	刺{諷~；揭發；採取}𪑟庛																							
dze	dze	疵胔飺骴																							
dzeh	dzeh	眥漬																							
se	se	斯廝厮蟴蟖蜤些																							
seʔ	seq	佌𠈈																							
seh	seh	澌																							
le	le	訑易{和悅}螔																							
leh	leh	易{容~、輕~}																							
les	les	曳抴勩																							
sle	sle	虒禠鼶榹㾷																							
sleh	sleh	賜																							
mleʔ	mleq	舐𦧇																							
re	re	驪樆																							
res	res	栵																							
C.re	C.re	劙																							
ke	ke	支枝肢枳只榰胑𩢢卮巵梔疻																							
keʔ	keq	咫軹𣲵																							
keh	keh	忮翅																							
kes	kes	瘈觢																							
kʰeʔ	kheq	企跂																							
kʰeh	kheh	蚑																							
kʰes	khes	掣痸																							
ge	ge	歧岐疧蚔伎																							
ŋe	nge	兒																							
ŋes	nges	埶蓺藝秇槸帠																							
ŋ̊es	nhges	勢																							
kwe	kwe	規鬹																							
kweh	kweh	瞡																							
kʰwe	khwe	闚窺																							
kʰweʔ	khweq	頍跬蹞																							
weʔ	weq	𤼒																							
ẘes	whes	繐																							
ẘe	whe	觿鑴																							
ẘeh	wheh	孈																							
wes	wes	彗篲鏏																							
ʔeh	qeh	縊																							
ʔweh	qweh	恚㜇																							
pre	pre	碑																							
tre	tre	知蜘䵹																							
treh	treh	智𢜔																							
dre	dre	踟																							
tsres	tsres	瘵祭{~伯}																							
lre	lre	篪褫																							
lreʔ	lreq	䚦																							
lres	lres	彘{地名}																							
sreʔ	sreq	灑纚矖																							
sreh	sreh	曬																							
kre	kre	妓{姕~，婦女貌；一說婦女不美}																							
kres	kres	猘																							
kʰreʔ	khreq	䞚																							
kʰres	khres	甈																							
greʔ	greq	技																							
greh	greh	芰鬾																							
ŋres	ngres	劓㓷																							
kwreʔ	kwreq	庪																							
ʔres	qres	瘞																							
pˤe	p'e	豍																							
pʰˤe	ph'e	錍																							
pʰˤeʔ	ph'eq	䫌																							
bˤe	b'e	鼙椑{橢圓}鞞																							
bˤeh	b'eh	嬖薜																							
mˤe	m'e	麛																							
mˤeʔ	m'eq	蔝																							
tˤe	t'e	鞮堤隄																							
tˤeh	t'eh	帝諦																							
tˤes	t'es	蔕蒂蝃{~蝀，彩虹}螮{~蝀，彩虹}																							
tʰˤeʔ	th'eq	緹醍																							
tʰˤeh	th'eh	褅揥																							
dˤe	d'e	提題騠鯷媞偍折{~~，安舒}䱱																							
dˤeʔ	d'eq	忯																							
dˤeh	d'eh	提{~~，安舒}踶締禘																							
dˤes	d'es	墆遰杕																							
nˤe	n'e	臡																							
nˤeʔ	n'eq	檷薾濔{~~，多}																							
tsˤes	ts'es	裚																							
tsʰˤeʔ	tsh'eq	泚玼																							
dzˤeʔ	dz'eq	鮆																							
sˤe	s'e	撕嘶																							
sˤeʔ	s'eq	𧬊鮮{美善，同“𧬊”}																							
sˤeh	s'eh	細																							
lˤe	l'e	蹏蹄嗁啼																							
lˤeʔ	l'eq	遞																							
lˤeh	l'eh	地{《韓非子》、秦文}墬髢																							
lˤes	l'es	䲦																							
l̥ˤe	lh'e	鷉																							
rˤeʔ	r'eq	蠡欐																							
rˤeh	r'eh	麗攦儷丽荔䬅㿛																							
rˤes	r'es	戾{到達；安定；率領}䓞悷盭𤟑																							
C.rˤes	C.r'es	隸																							
kˤe	k'e	鷄雞笄筓枅																							
kˤeh	k'eh	繼檵繫蘻轚檕係峜																							
kˤes	k'es	薊葪紒																							
kʰˤe	kh'e	谿溪鸂																							
kʰˤeʔ	kh'eq	启啟啓䡔䏿綮棨																							
kʰˤeh	kh'eh	罊蟿䁈																							
kʰˤes	kh'es	契																							
gˤe	g'e	兮奚蒵鼷貕螇榽蹊傒騱																							
gˤeʔ	g'eq	徯謑																							
gˤeh	g'eh	系																							
gˤes	g'es	妎																							
ŋˤe	ng'e	倪婗蜺{寒蟬}鯢䘽郳麑猊齯輗																							
ŋˤeʔ	ng'eq	掜堄																							
ŋˤeh	ng'eh	睨盻羿																							
hˤe	h'e	醯橀																							
kwˤe	kw'e	圭珪閨邽袿𦓯																							
kwˤeh	kw'eh	桂筀																							
kʰwˤe	khw'e	茥奎刲																							
gwˤe	gw'e	畦窐																							
wˤe	w'e	巂攜觿{觜~}嶲{觜~}蠵酅驨																							
wˤes	w'es	慧																							
ẘˤes	wh'es	嘒嚖																							
ʔˤe	q'e	嫛																							
ʔˤeh	q'eh	瘱																							
ʔˤes	q'es	翳𠣗㝣																							
pˤreʔ	p'req	捭																							
pʰˤreh	ph'reh	𥿯派																							
bˤre	b're	螷																							
bˤreʔ	b'req	猈																							
bˤreh	b'reh	粺稗																							
tʰˤres	th'res	傺																							
nˤre	n're	誽																							
tsˤreh	ts'reh	債																							
dzˤre	dz're	柴㧘																							
dzˤreh	dz'reh	眦																							
lˤreʔ	l'req	豸																							
kˤre	k're	佳街																							
kˤreʔ	k'req	解薢																							
kˤreh	k'reh	懈繲																							
kˤres	k'res	介价玠芥魀恝疥界																							
gˤre	g're	鮭																							
gˤreʔ	g'req	解{理~、通徹；地名}蟹嶰獬																							
gˤreh	g'reh	邂解{物體連接處}																							
gˤres	g'res	齘																							
ŋˤre	ng're	厓崖涯嘊																							
ŋˤreh	ng'reh	睚																							
kwˤreh	kw'reh	卦掛詿																							
kwˤres	kw'res	夬																							
kʰwˤreh	khw'reh	絓																							
kʰwˤres	khw'res	快																							
wˤreʔ	w'req	讗																							
ẘˤres	wh'res	咶																							
ʔˤre	q're	哇娃唲{~嘔}																							
ʔˤreh	q'reh	阸阨{扼制；險要}																							
ʔwˤre	qw're	洼蛙鼃																							
peŋ	peng	并𥩵																							
peŋʔ	pengq	屏{隱藏、退避}鉼餅																							
pek	pek	辟{君主；消除}璧躄綼																							
pʰeŋh	phengh	聘娉																							
pʰek	phek	僻																							
beŋh	bengh	偋																							
bek	bek	辟{法治；便~，諂媚}闢萆擗躃																							
meŋ	meng	名																							
teŋ	teng	正征鉦																							
teŋʔ	tengq	整																							
teŋh	tengh	政証																							
tek	tek	隻																							
stek	stek	適																							
deŋ	deng	成城誠郕																							
deŋh	dengh	盛晟																							
tseŋ	tseng	精菁旌鶄箐蜻婧																							
tseŋʔ	tsengq	井																							
tsek	tsek	脊跡迹積蹟鰿𧐐䳭																							
tsʰeŋ	tsheng	清瀞																							
tsʰeŋʔ	tshengq	請																							
tsʰeŋh	tshengh	凊																							
tsʰek	tshek	刺																							
dzeŋ	dzeng	情晴𢚏																							
dzeŋʔ	dzengq	靖竫妌阱穽																							
dzeŋh	dzengh	靜靚淨																							
dzek	dzek	塉瘠膌																							
seŋʔ	sengq	省																							
seŋh	sengh	姓性																							
leŋ	leng	盈楹桯贏嬴籯瀛溋																							
leŋʔ	lengq	郢浧																							
lek	lek	易{交~、周~}埸蜴																							
l̥eŋ	lheng	聲																							
l̥eŋh	lhengh	聖																							
slek	slek	鬄																							
reŋʔ	rengq	領																							
keŋʔ	kengq	頸勁																							
kʰeŋ	kheng	輕																							
kʰeŋh	khengh	鑋																							
geŋ	geng	葝																							
geŋʔ	gengq	痙																							
kʰweŋ	khweng	傾																							
kʰweŋʔ	khwengq	頃																							
gweŋ	gweng	睘{~~，孤獨}煢焭瓊藑惸嬛{~~，孤獨}𨍶																							
weŋ	weng	塋營巆謍																							
weŋʔ	wengq	潁穎																							
wek	wek	役疫垼																							
ẘeŋ	wheng	觪騂{赤紅}觲																							
ẘeŋh	whengh	敻讂詗																							
ʔeŋ	qeng	嬰纓蘡攖𤣎																							
ʔeŋʔ	qengq	癭𩖍																							
ʔek	qek	益膉嗌齸𪕶																							
ʔweŋ	qweng	縈褮																							
breŋ	breng	平苹評泙																							
mreŋ	mreng	鳴																							
treŋ	treng	貞楨禎																							
tʰreŋ	threng	竀虰																							
tʰreŋh	threngh	偵𠏄																							
dreŋh	drengh	鄭㽀																							
drek	drek	擲擿躑																							
tsreŋ	tsreng	爭箏猙䋫																							
tsreŋh	tsrengh	諍																							
tsrek	tsrek	責簀幘																							
tsʰrek	tshrek	冊柵𩒄策皟䶦																							
dzreŋ	dzreng	埩{耕種}																							
sreŋ	sreng	生牲笙鼪甥狌猩																							
sreŋʔ	srengq	眚渻																							
lreŋ	lreng	酲程裎挰																							
l̥reŋ	lhreng	逞珵檉																							
l̥reŋʔ	lhrengq	騁																							
r̥eŋ	rheng	䞓赬																							
kreŋ	kreng	驚荆荊蟼																							
kreŋʔ	krengq	警䜘擏儆憼																							
kreŋh	krengh	敬																							
greŋ	greng	檠擎																							
grek	grek	屐																							
wreŋ	wreng	榮瑩禜蠑																							
pˤeŋʔ	p'engq	鞞																							
pˤek	p'ek	壁繴																							
pʰˤeŋ	ph'eng	甹{~蜂，牽挽、扶持}荓艵																							
pʰˤeŋʔ	ph'engq	頩																							
pʰˤek	ph'ek	霹澼																							
bˤeŋ	b'eng	屏{~幕、~障}瓶缾荓蓱萍郱蛢洴鵧𤳊䶄																							
bˤeŋʔ	b'engq	併軿																							
bˤek	b'ek	辟{內棺}甓椑{內棺}																							
mˤeŋ	m'eng	銘冥瞑螟溟覭鄍																							
mˤeŋʔ	m'engq	黽																							
mˤeŋh	m'engh	暝																							
mˤek	m'ek	幦覓幭霢{~霂，小雨}霡{~霂，小雨}蓂冪鼏幎塓																							
tˤeŋ	t'eng	丁釘																							
tˤeŋʔ	t'engq	鼎薡頂葶																							
tˤeŋh	t'engh	顁																							
tˤek	t'ek	滴適{滿足；美善；歸順；辟領}蹢嫡甋樀豴																							
tʰˤeŋ	th'eng	町艼汀																							
dˤeŋ	d'eng	亭停楟定																							
dˤek	d'ek	敵																							
nˤeŋ	n'eng	寍寧濘鸋𨚶																							
nˤeŋʔ	n'engq	䔭																							
nˤeŋh	n'engh	甯																							
tsˤek	ts'ek	績																							
tsʰˤeŋ	tsh'eng	青																							
sˤeŋ	s'eng	星腥煋胜																							
sˤeŋʔ	s'engq	醒																							
sˤek	s'ek	析晳皙蜥淅㭊菥																							
lˤeŋ	l'eng	廷庭霆莛鼮筳娗																							
lˤeŋʔ	l'engq	挺梃蜓鋌																							
lˤek	l'ek	荻																							
slˤek	sl'ek	錫裼緆																							
l̥ˤeŋ	lh'eng	聽																							
l̥ˤeŋʔ	lh'engq	珽頲脡																							
l̥ˤek	lh'ek	剔逷踢狄惕悐逖																							
rˤeŋ	r'eng	靈蘦蛉鴒𩵀麢櫺酃𩆚																							
rˤeŋʔ	r'engq	冷																							
rˤek	r'ek	厤歷{~錄，文采貌}瀝靂磿藶櫪蚸																							
C.rˤeŋ	C.r'eng	令{春秋晚期以後}																							
C.rˤek	C.r'ek	鬲䰛蒚歷曆酈																							
kˤeŋ	k'eng	涇經鵛																							
kˤeŋʔ	k'engq	剄																							
kˤeŋh	k'engh	徑俓逕																							
kˤek	k'ek	擊墼																							
kʰˤeŋʔ	kh'engq	謦																							
kʰˤeŋh	kh'engh	磬罄																							
kʰˤek	kh'ek	喫																							
gˤeŋ	g'eng	形刑型邢鉶侀硎陘鈃娙																							
gˤeŋʔ	g'engq	婞涬悻																							
gˤeŋh	g'engh	脛																							
gˤek	g'ek	奊覡																							
ŋˤek	ng'ek	鷊鶂鶃鷁虉																							
ŋ̊ˤek	nhg'ek	鬩																							
hˤeŋ	h'eng	蛵馨																							
kwˤeŋ	kw'eng	熲駫駉坰																							
kwˤeŋʔ	kw'engq	炯扃烓																							
kwˤek	kw'ek	鶪鴃湨溴郹鵙犑鼳鼰																							
kʰwˤeŋʔ	khw'engq	褧絅																							
kʰwˤek	khw'ek	闃																							
gwˤeŋʔ	gw'engq	迥泂																							
wˤeŋ	w'eng	熒滎螢䁝																							
ẘˤek	wh'ek	狊砉殈																							
ʔwˤeŋh	qw'engh	鎣																							
pˤreŋ	p'reng	絣拼㔙																							
pˤreŋh	p'rengh	迸																							
pˤrek	p'rek	蘗擘																							
pʰˤreŋ	ph'reng	抨怦伻荓{使}																							
pʰˤrek	ph'rek	糪																							
mˤreŋ	m'reng	命{春秋晚期以後}																							
mˤreŋʔ	m'rengq	鼆																							
mˤrek	m'rek	脉脈覛																							
tˤreŋ	t'reng	丁{~~，伐木聲}朾																							
tˤrek	t'rek	摘謫讁瓋																							
dˤreŋh	d'rengh	䘺																							
dˤrek	d'rek	適{譴責；天象變異}																							
nˤreŋ	n'reng	薴																							
tsʰˤrek	tsh'rek	茦莿																							
dzˤreŋ	dz'reng	崝崢																							
dzˤrek	dz'rek	賾嘖																							
kˤreŋ	k'reng	耕𣚣																							
kˤreŋʔ	k'rengq	耿																							
kˤrek	k'rek	隔膈搹鞷																							
kʰˤreŋ	kh'reng	牼硜誙																							
gˤreŋ	g'reng	莖																							
gˤreŋʔ	g'rengq	幸倖																							
gˤrek	g'rek	翮塥																							
gwˤrek	gw'rek	嫿																							
wˤreŋ	w'reng	嶸																							
wˤrek	w'rek	畫劃																							
ẘˤreŋ	wh'reng	轟輷																							
ʔˤreŋ	q'reng	櫻嚶罌罃鶯鸚																							
ʔˤrek	q'rek	厄戹隘阸阨{險要處}豟䝈軛軶扼蚅搤𩚬																							
ʔwˤreŋ	qw'reng	泓																							
pen	pen	鞭鯾編箯																							
penʔ	penq	褊																							
pet	pet	鼈蟞龞鱉鷩虌𡐞																							
pʰen	phen	偏翩{疾飛}篇媥																							
pʰet	phet	憋																							
ben	ben	便楩緶																							
benʔ	benq	楩䡢																							
men	men	媔緜綿矊矏櫋蝒																							
menʔ	menq	湎偭緬勔黽{~池}澠{~池}沔																							
menh	menh	面																							
met	met	滅搣																							
m̥et	mhet	烕																							
tet	tet	折{~斷}																							
det	det	折{斷}																							
snenʔ	snenq	獮																							
tsen	tsen	煎																							
tsenʔ	tsenq	翦剪鬋戩揃																							
tsenh	tsenh	葥箭																							
tset	tset	蠽																							
tsʰenʔ	tshenq	淺																							
set	set	禼契{商祖}																							
let	let	逸{~~，有序}																							
ret	ret	列{陳列，行列；各；陳述}																							
kʰenʔ	khenq	遣																							
kʰenh	khenh	譴																							
ŋ̊et	nhget	褻𣊓暬																							
kwenh	kwenh	絹鄄狷																							
kʰwet	khwet	缺蒛																							
gwenʔ	gwenq	蜎{孑孓}																							
wen	wen	捐旋璇琁還{同“旋”，旋轉；立即}璿																							
wenh	wenh	睿叡																							
ẘen	when	儇翾																							
ẘenʔ	whenq	蠉																							
ẘet	whet	吷																							
ʔwen	qwen	嬽娟蜎{彎曲}悁																							
pret	pret	別{分解、辨~}扒																							
brenʔ	brenq	辨辯諞																							
bret	bret	別																							
trenʔ	trenq	輾																							
tret	tret	哲																							
lret	lret	撤轍澈徹																							
kret	kret	孑																							
kʰrenʔ	khrenq	繾																							
ŋret	ngret	闑槷																							
gwren	gwren	鬈卷{美好}																							
pˤen	p'en	邊籩編蝙甂																							
pˤenʔ	p'enq	扁萹惼																							
pˤenh	p'enh	遍徧																							
pʰˤen	ph'en	猵																							
pʰˤenh	ph'enh	片																							
pʰˤet	ph'et	嫳																							
bˤen	b'en	胼跰楄																							
bˤenʔ	b'enq	扁{~鵲}辮																							
bˤet	b'et	蹩蛂																							
mˤen	m'en	䰓																							
mˤenh	m'enh	眄麪																							
mˤet	m'et	蔑鱴薎篾蠛𥾝																							
tˤenʔ	t'enq	蕇																							
tʰˤenʔ	th'enq	靦																							
tsˤen	ts'en	湔淺{~~，水流疾}箋																							
tsʰˤet	tsh'et	竊																							
dzˤen	dz'en	前																							
dzˤet	dz'et	截																							
sˤen	s'en	𨇤{跰~}																							
sˤenh	s'enh	霰䨘																							
sˤet	s'et	躠																							
rˤenh	r'enh	萰煉楝湅僆																							
C.rˤen	C.r'en	蓮																							
C.rˤenh	C.r'enh	練鍊																							
kˤen	k'en	肩猏菺豜麉																							
kˤenʔ	k'enq	繭襺蠒趼𢆞																							
kˤenh	k'enh	見																							
kˤet	k'et	潔絜鍥																							
kʰˤen	kh'en	汧岍雃蚈																							
kʰˤenh	kh'enh	俔																							
kʰˤet	kh'et	挈栔																							
gˤenʔ	g'enq	睍{~睆，鳥聲清和圓轉}蜆峴垷																							
gˤenh	g'enh	現																							
gˤet	g'et	緳																							
ŋˤen	ng'en	研鳽																							
ŋˤenʔ	ng'enq	齞																							
ŋˤenh	ng'enh	𤜵硯																							
ŋˤet	ng'et	霓蜺{~虹}臬齧嚙																							
ŋ̊ˤet	nhg'et	楔{~子}																							
hˤen	h'en	詽																							
hˤenʔ	h'enq	顯韅																							
kwˤen	kw'en	涓睊蠲䅌																							
kwˤenh	kw'enh	懁獧																							
kwˤet	kw'et	決玦駃抉訣鴂䏐䦼																							
gwˤen	gw'en	懸縣𠐴																							
gwˤenʔ	gw'enq	鞙琄䧎																							
gwˤenh	gw'enh	縣{郡~}																							
wˤenʔ	w'enq	繯																							
ẘˤen	wh'en	駽																							
ẘˤet	wh'et	決{迅疾}袂																							
ʔˤen	q'en	燕驠																							
ʔˤenh	q'enh	宴讌觾鷰酀																							
ʔwˤen	qw'en	蜎{~~，昆蟲蠕動爬行狀}																							
ʔwˤenh	qw'enh	噮																							
ʔwˤet	qw'et	妜																							
pˤret	p'ret	八																							
bˤrenh	b'renh	辨瓣辦																							
tsˤret	ts'ret	札蚻																							
tsʰˤret	tsh'ret	察																							
dzˤren	dz'ren	虦																							
kˤren	k'ren	間蕑																							
kˤrenʔ	k'renq	簡柬揀																							
kˤrenh	k'renh	覸鐗																							
kˤret	k'ret	揳楔																							
kʰˤren	kh'ren	顅																							
gˤren	g'ren	閑{~~，眾多}閒瞷癇嫺																							
gˤrenh	g'renh	莧																							
wˤren	w'ren	環寰還圜鐶轘㡲䭴闤																							
wˤrenh	w'renh	擐																							
ʔˤret	q'ret	窫䝟揠																							
tem	tem	占																							
tep	tep	懾																							
tʰem	them	㚲																							
stem	stem	苫痁																							
nem	nem	蛅																							
n̥ep	nhep	攝																							
tsem	tsem	瀸殲																							
tsʰem	tshem	孅僉																							
dzem	dzem	潛																							
sem	sem	憸																							
lem	lem	阽																							
slem	slem	銛																							
l̥ep	lhep	偞																							
rem	rem	廉簾𢅏薕鎌蠊覝																							
remʔ	remq	䭑																							
ʔem	qem	饜懕																							
ʔemʔ	qemq	檿黶																							
ʔemh	qemh	厭{~煩；滿足；合適；美盛}																							
ʔep	qep	猒厭{壓；堵塞；迫近；降低}擫擪靨																							
prem	prem	砭																							
premʔ	premq	貶																							
trem	trem	霑																							
trep	trep	輒																							
tʰrem	threm	覘佔{~畢}																							
nrem	nrem	黏																							
nrep	nrep	籋																							
tˤem	t'em	沾																							
tˤemʔ	t'emq	玷點																							
tˤemh	t'emh	坫																							
tʰˤep	th'ep	鉆帖怗																							
nˤep	n'ep	苶																							
n̥ˤemh	nh'emh	𨸱																							
sˤep	s'ep	燮																							
lˤem	l'em	恬甜																							
lˤep	l'ep	牒蝶諜蹀堞褋																							
l̥ˤemʔ	lh'emq	餂																							
rˤem	r'em	溓磏鬑																							
kˤem	k'em	兼蒹鶼縑																							
kˤep	k'ep	莢頰鋏䛟																							
kʰˤem	kh'em	謙																							
kʰˤemʔ	kh'emq	慊嗛歉																							
kʰˤemh	kh'emh	傔																							
kʰˤep	kh'ep	愜篋																							
gˤem	g'em	嫌																							
gˤemʔ	g'emq	鼸㺌																							
gˤep	g'ep	挾協俠勰																							
hˤem	h'em	䵌																							
kˤrep	k'rep	夾郟筴梜浹																							
gˤrep	g'rep	狹陜峽																							
ʔˤrep	q'rep	壓																							
pew	pew	猋贆標熛蔈																							
pʰew	phew	漂嘌飄嫖{輕}																							
pʰewʔ	phewq	𣿖縹皫																							
pʰewh	phewh	爂僄																							
bew	bew	瀌瓢																							
bewʔ	bewq	剽摽																							
bewh	bewh	驃																							
mewʔ	mewq	淼杪渺眇訬篎藐																							
mewh	mewh	妙																							
tewh	tewh	詔																							
tewk	tewk	灼酌彴妁																							
stewʔ	stewq	少																							
tʰew	thew	紹{緩慢}																							
dewʔ	dewq	紹																							
dewk	dewk	勺汋																							
newk	newk	弱蒻䐞																							
tsew	tsew	焦椒蕉𨶲噍{聲音急促}鷦																							
tsewh	tsewh	灂潐僬爝																							
tsewk	tsewk	雀爵燋釂醮																							
tsʰew	tshew	𠝡𣂁																							
tsʰewʔ	tshewq	愀悄																							
tsʰewh	tshewh	哨																							
dzew	dzew	譙樵憔																							
dzewh	dzewh	噍{咀嚼}誚																							
sew	sew	消銷宵霄痟																							
sewʔ	sewq	小																							
sewk	sewk	削																							
lew	lew	窰䠛銚珧搖徭																							
lewh	lewh	耀燿																							
lewk	lewk	龠籥禴爚鑰躍礿																							
rewʔ	rewq	僚{美好}爒																							
rewh	rewh	療																							
kew	kew	招																							
kewʔ	kewq	沼																							
kewk	kewk	繳																							
kʰew	khew	繑趬																							
gew	gew	柖翹荍																							
ŋew	ngew	橈{船槳}蕘饒蟯																							
ŋewʔ	ngewq	繞																							
ŋ̊ew	nhgew	燒																							
ʔew	qew	要腰葽喓䳩邀																							
ʔewk	qewk	約葯																							
brewʔ	brewq	𣧶殍																							
mrewh	mrewh	廟庿																							
drewʔ	drewq	趙																							
tsrewk	tsrewk	穛穱																							
tsʰrew	tshrew	鈔抄																							
srew	srew	筲䈰																							
srewh	srewh	稍																							
lrewʔ	lrewq	鮡																							
tˤew	t'ew	刁貂䂏																							
tˤewh	t'ewh	釣瘹																							
tˤewk	t'ewk	的馰魡靮杓芍{鳧茈}																							
dˤew	d'ew	芀苕祒																							
dˤewh	d'ewh	掉																							
nˤewʔ	n'ewq	嬈																							
nˤewh	n'ewh	尿																							
nˤewk	n'ewk	嫋溺																							
sˤew	s'ew	萷箾{樂名；韶~}揱捎																							
lˤew	l'ew	跳																							
lˤewʔ	l'ewq	窕誂																							
lˤewh	l'ewh	藋																							
lˤewk	l'ewk	翟狄{戎~}糴																							
l̥ˤew	lh'ew	恌祧佻𠝡𣂁																							
l̥ˤewʔ	lh'ewq	宨																							
l̥ˤewh	lh'ewh	眺糶頫覜																							
l̥ˤewk	lh'ewk	趯籊																							
rˤew	r'ew	遼瞭僚繚{纏}寮鷯料敹嵺膋膫鐐																							
rˤewʔ	r'ewq	繚{趙~，長}憭																							
rˤewh	r'ewh	獠																							
rˤewk	r'ewk	櫟礫擽躒䟏皪																							
kˤew	k'ew	梟儌憿澆𣻏																							
kˤewʔ	k'ewq	皎晈恔敫皦曒																							
kˤewh	k'ewh	徼噭獥																							
kˤewk	k'ewk	激鸄																							
kʰˤewh	kh'ewh	竅																							
gˤewʔ	g'ewq	皛																							
gˤewk	g'ewk	檄獥薂䚫																							
ŋˤew	ng'ew	堯僥{焦~}																							
ŋˤewh	ng'ewh	嘄																							
ŋ̊ˤew	nhg'ew	嘵憢膮																							
ŋ̊ˤewʔ	nhg'ewq	曉																							
ʔˤewʔ	q'ewq	杳窅㝔宎窈葽{~繞，草名}																							
ʔˤewh	q'ewh	窔																							
pˤrewh	p'rewh	豹																							
bˤrewk	b'rewk	瓝																							
mˤrewh	m'rewh	貌䫉																							
mˤrewk	m'rewk	邈																							
tˤrew	t'rew	鳭																							
nˤrew	n'rew	呶怓鐃譊																							
nˤrewh	n'rewh	橈																							
nˤrewk	n'rewk	搦																							
sˤrewk	s'rewk	𦂗箾{舞者所執之竿；象~}																							
lˤrewh	l'rewh	櫂																							
lˤrewk	l'rewk	濯擢鸐																							
kˤrew	k'rew	鵁																							
kˤrewʔ	k'rewq	絞狡姣																							
kˤrewh	k'rewh	校																							
kʰˤrew	kh'rew	磽墝骹																							
kʰˤrewh	kh'rewh	撽																							
gˤrew	g'rew	筊																							
gˤrewh	g'rewh	效効校{學~；呈現；愉悅}																							
gˤrewk	g'rewk	覈																							
hˤrew	h'rew	髐																							
hˤrewh	h'rewh	詨																							
ʔˤrew	q'rew	咬																							
ʔˤrewk	q'rewk	箹																							
piʔ	piq	匕妣秕粃朼																							
pih	pih	𦸣䃾																							
pis	pis	蔽{~芾，小而茂密}畀痹痺庇疪																							
pʰiʔ	phiq	仳																							
pʰis	phis	屁																							
bi	bi	膍芘毗毘阰魮貔枇肶蚍㮰																							
biʔ	biq	牝比{~較}																							
bis	bis	比紕鼻																							
mis	mis	寐																							
tiʔ	tiq	厎砥㕄扺耆{致使，達到；進獻}																							
tih	tih	至寘																							
tis	tis	鷙贄摯䲀桎侄晊郅																							
tʰi	thi	鴟𩿨																							
tʰih	thih	痓																							
diʔ	diq	視{看；教導}眂眡																							
dih	dih	視{比；生存；接納}示{主動示人，顯現；告知；教導}																							
nis	nis	二貳樲																							
tsi	tsi	咨資姿粢諮齎齍																							
tsiʔ	tsiq	秭姊𡛷																							
tsih	tsih	資{鋒利；極、最}																							
tsis	tsis	恣次{榆~}																							
tsʰi	tshi	郪次{~且，猶豫}𡰾																							
tsʰis	tshis	次佽絘䳐																							
dzi	dzi	茨薋蠐{蝤~}餈																							
dzis	dzis	嫉自																							
li	li	伊荑洟痍鮧彝																							
l̥i	lhi	屍{主掌；死~}鳲屎{殿~，呻吟}																							
l̥iʔ	lhiq	屎矢																							
l̥is	lhis	呬																							
sliʔ	sliq	死兕																							
slis	slis	四泗柶駟																							
mlih	mlih	諡謚																							
ri	ri	梨棃犂犛𪁐鵹𢤂																							
ris	ris	利																							
ki	ki	脂																							
kiʔ	kiq	旨指																							
kʰis	khis	棄㞓																							
gi	gi	祁{盛大}嗜鮨																							
gih	gih	示{展~；安置}																							
ŋi	ngi	狋																							
hi	hi	蓍																							
kwiʔ	kwiq	癸																							
kwis	kwis	季																							
gwi	gwi	葵䳫																							
gwiʔ	gwiq	揆嫢																							
gwis	gwis	悸																							
wi	wi	維惟唯濰																							
wiʔ	wiq	鷕蜼																							
ẘi	whi	雖睢																							
wis	wis	穗蔧																							
ʔi	qi	咿蛜																							
prih	prih	祕毖閟泌秘柲																							
pʰris	phris	濞																							
briʔ	briq	㠲																							
bris	bris	贔奰																							
mri	mri	麋蘪攗眉楣																							
mrih	mrih	媚䉋娓{順從}																							
triʔ	triq	黹																							
trih	trih	致輊駤																							
tris	tris	懫躓疐懥																							
tʰri	thri	絺脪																							
tʰrih	thrih	𦥊																							
driʔ	driq	泜																							
nris	nris	膩																							
n̥rih	nhrih	杘																							
tsriʔ	tsriq	笫胏																							
dzriʔ	dzriq	柹																							
sri	sri	師																							
lri	lri	墀																							
lriʔ	lriq	雉																							
l̥ris	lhris	訵																							
kriʔ	kriq	𪊨																							
gri	gri	鬐鰭耆{老}																							
griʔ	griq	跽																							
gwri	gwri	戣																							
wri	wri	帷																							
ʔrih	qrih	欭																							
ʔris	qris	懿饐鷧																							
pˤi	p'i	蓖㡙螕狴																							
pˤis	p'is	閉{關~，動詞}箅																							
pʰˤi	ph'i	批																							
pʰˤis	ph'is	媲淠																							
bˤi	b'i	笓																							
bˤiʔ	b'iq	陛蜌梐																							
mˤi	m'i	迷																							
mˤiʔ	m'iq	米眯㝥																							
tˤi	t'i	氐低羝䢑																							
tˤiʔ	t'iq	底詆抵軧弤邸菧																							
tˤis	t'is	嚏柢																							
nˤiʔ	n'iq	苨禰																							
n̥ˤih	nh'ih	替																							
tsˤi	ts'i	齎{託付}齌䪠䪡虀櫅𩐋																							
tsˤiʔ	ts'iq	濟{停止；~水；~~，眾多}䮺䍤																							
tsˤih	ts'ih	霽擠																							
dzˤi	dz'i	齊{人名}懠蠐{~螬}臍																							
dzˤiʔ	dz'iq	薺																							
dzˤih	dz'ih	癠劑																							
sˤis	s'is	壻婿																							
lˤi	l'i	稊蕛綈𣸒																							
lˤiʔ	l'iq	弟																							
lˤih	l'ih	第																							
slˤi	sl'i	犀																							
l̥ˤiʔ	lh'iq	涕																							
l̥ˤih	lh'ih	剃																							
l̥ˤis	lh'is	薙																							
rˤi	r'i	犁鯬邌																							
rˤiʔ	r'iq	禮醴鱧澧																							
rˤis	r'is	戾{彎曲；暴戾}																							
r̥ˤiʔ	rh'iq	體																							
kˤi	k'i	稽																							
kˤis	k'is	計髻																							
kʰˤiʔ	kh'iq	䭫稽																							
ŋˤis	ng'is	詣																							
kʰwˤi	khw'i	睽藈																							
wˤis	w'is	惠蕙譓蟪																							
ʔˤi	q'i	鷖繄																							
ʔˤis	q'is	嫕殪曀豷																							
tsˤri	ts'ri	齋																							
dzˤri	dz'ri	儕																							
kˤri	k'ri	階																							
kˤriʔ	k'riq	皆偕																							
kˤris	k'ris	屆																							
hˤris	h'ris	㞒																							
wˤri	w'ri	淮																							
pik	pik	必珌鮅																							
pʰik	phik	匹疋																							
bik	bik	怭邲苾																							
mik	mik	謐																							
tiŋ	ting	真眞磌																							
tik	tik	質鑕蛭																							
stik	stik	室																							
tʰiŋ	thing	瞋謓																							
diŋh	dingh	㐨																							
dik	dik	實																							
niŋ	ning	人仁																							
niŋh	ningh	認韌																							
nik	nik	日																							
n̥iŋ	nhing	身																							
sniŋ	sning	信																							
tsiŋh	tsingh	晉㬐搢縉																							
tsik	tsik	即卽堲蝍																							
tsʰiŋ	tshing	親																							
tsʰik	tshik	桼漆																							
dziŋ	dzing	秦螓																							
dziŋh	dzingh	藎贐																							
dzik	dzik	疾衋槉蒺																							
siŋ	sing	辛新薪																							
siŋh	singh	訊迅																							
sik	sik	悉膝																							
liŋ	ling	寅蔩夤																							
lik	lik	溢鎰逸佚佾軼																							
l̥iŋ	lhing	呻																							
l̥ik	lhik	失																							
riŋ	ring	粼旍																							
rik	rik	栗慄鷅麜																							
kwik	kwik	橘繘蹫																							
gwik	gwik	僪																							
wik	wik	驈潏{水中土石工程}遹鷸鱊噊鴥																							
ʔiŋ	qing	姻婣																							
ʔik	qik	壹																							
prik	prik	鉍潷																							
brik	brik	駜																							
triŋ	tring	鎮																							
trik	trik	窒挃銍																							
nrik	nrik	衵																							
tsriŋ	tsring	臻𧽕溱榛蓁																							
tsrik	tsrik	櫛																							
tsʰriŋh	tshringh	櫬襯																							
sriŋ	sring	莘{國名}峷侁甡阠																							
srik	srik	瑟螅蝨虱																							
lrik	lrik	秩紩翐柣祑袠豑																							
l̥rik	lhrik	抶																							
kriŋ	kring	矜																							
ẘrik	whrik	淢洫侐																							
ʔrik	qrik	抑																							
pˤik	p'ik	佖																							
pʰˤik	ph'ik	覕																							
bˤiŋ	b'ing	骿駢																							
mˤik	m'ik	汨																							
tˤiŋ	t'ing	顛蹎巔瘨齻傎癲																							
tʰˤiŋ	th'ing	瑱																							
tʰˤik	th'ik	蛈																							
dˤiŋ	d'ing	闐填窴鷏搷磌																							
dˤiŋh	d'ingh	奠淀																							
dˤik	d'ik	絰咥垤耋臷姪恎																							
nˤiŋ	n'ing	年佞																							
nˤik	n'ik	涅篞																							
tsˤik	ts'ik	節楶癤																							
tsʰˤiŋ	tsh'ing	千阡芊																							
tsʰˤiŋh	tsh'ingh	倩蒨輤																							
sˤiŋh	s'ingh	綪																							
sˤik	s'ik	僁																							
lˤiŋ	l'ing	田甸畋佃																							
lˤiŋh	l'ingh	電																							
lˤik	l'ik	跌迭瓞佚{~宕，放肆爲禍}泆軼{同“迭”}苵驖眣昳镻胅凸𥥌																							
slˤik	sl'ik	屑																							
l̥ˤiŋ	lh'ing	天																							
l̥ˤik	lh'ik	鐵銕鴩																							
rˤiŋ	r'ing	呤鈴瓴軨苓坽零泠齡囹伶翎舲聆																							
C.rˤiŋ	C.r'ing	憐矜{同情}令{春秋晚期以前}瘝																							
kwˤik	kw'ik	譎鐍觼潏{水名}憰芵鴂																							
kʰwˤik	khw'ik	闋湀																							
wˤik	w'ik	矞穴袕																							
ʔˤik	q'ik	噎																							
ʔwˤiŋ	qw'ing	𣶒淵鼘																							
mˤriŋ	m'ring	命{春秋晚期以前}																							
tˤriŋh	t'ringh	綻																							
kwˤrik	kw'rik	劀鱊																							
pin	pin	賓賔濱儐檳瀕																							
pinh	pinh	殯擯鬢																							
pit	pit	畢韠罼彃縪觱蹕篳䟆																							
pʰin	phin	翩{飄揚；~~，往來貌}繽																							
bin	bin	頻蘋嚬薲矉嬪																							
binʔ	binq	臏髕																							
min	min	民泯																							
minʔ	minq	黽{~勉}																							
mit	mit	蜜蠠																							
m̥it	mhit	戌																							
nit	nit	馹																							
tsin	tsin	津進																							
tsinʔ	tsinq	盡{~量}																							
tsʰit	tshit	七柒																							
dzin	dzin	燼																							
dzinʔ	dzinq	盡																							
kin	kin	甄𪃋籈薽																							
kinʔ	kinq	緊																							
kinh	kinh	挋																							
kit	kit	吉拮																							
kʰinh	khinh	菣																							
kʰit	khit	詰蛣																							
gin	gin	臣茞																							
ginʔ	ginq	腎𦜜																							
kwin	kwin	均鈞袀																							
kwinh	kwinh	𧥺																							
win	win	勻匀旬畇䘩																							
ẘin	whin	荀詢眴洵恂珣郇橁畇𣖼																							
ẘinʔ	whinq	隼鶽筍笋																							
ẘinh	whinh	濬迿																							
ẘit	whit	恤卹獝																							
winh	winh	殉徇侚𢓈																							
ʔin	qin	因茵絪湮禋歅諲闉堙䃌																							
ʔinh	qinh	印																							
ʔit	qit	一																							
mrin	mrin	岷㞶崏珉																							
mrit	mrit	宓密蔤峚																							
tsʰrinʔ	tshrinq	齔齓																							
srit	srit	蟋																							
grit	grit	佶姞																							
ŋrin	ngrin	嚚																							
wrin	wrin	筠																							
wrinʔ	wrinq	荺																							
wrinh	wrinh	韻																							
ʔrin	qrin	駰																							
ʔrit	qrit	乙鳦																							
pˤit	p'it	閉{封~，形容詞}袐																							
bˤin	b'in	蠙																							
bˤit	b'it	飶																							
mˤin	m'in	眠																							
tsʰˤit	tsh'it	切																							
l̥ˤinʔ	lh'inq	蚕{蜸~，蚯蚓}																							
kˤin	k'in	堅鰹																							
kˤit	k'it	結袺桔𡔢																							
kʰˤin	kh'in	牽掔																							
kʰˤinʔ	kh'inq	蜸																							
gˤin	g'in	賢弦誸絃蚿																							
gˤinʔ	g'inq	顈																							
gˤit	g'it	頡襭𤢺																							
ŋˤit	ng'it	隉{杌~，動搖不安}臲{~卼，動搖不安}																							
kwˤinʔ	kw'inq	甽汱																							
kʰwˤinʔ	khw'inq	犬畎																							
gwˤin	gw'in	玄眩																							
gwˤinʔ	gw'inq	鉉泫																							
gwˤinh	gw'inh	炫昡衒																							
wˤinʔ	w'inq	贙																							
ẘˤinh	wh'inh	絢																							
ẘˤit	wh'it	血泬瞲																							
ʔˤin	q'in	咽珚煙																							
ʔˤinh	q'inh	咽{吞~}																							
ʔˤit	q'it	㖶𢓨																							
pʰˤrinh	ph'rinh	盼{美目~兮}																							
kˤrit	k'rit	戛秸鴶																							
kʰˤrin	kh'rin	鏗硻																							
kʰˤrit	kh'rit	硈劼																							
gˤrit	g'rit	黠																							
kwˤrin	kw'rin	矜{老而無妻}鰥{老而無妻}鱞{老而無妻}																							
gwˤrinh	gw'rinh	幻{惑亂；~怪}																							
ʔˤrit	q'rit	軋																							
tip	tip	執																							
nimʔ	nimq	稔腍棯																							
nip	nip	廿																							
n̥imʔ	nhimq	諗淰																							
tsʰim	tshim	駸																							
tsʰimʔ	tshimq	寢																							
dzip	dzip	慹																							
slip	slip	卌																							
kim	kim	針鍼箴葴																							
kip	kip	汁																							
gip	gip	十什拾																							
ʔim	qim	愔																							
ʔip	qip	揖挹俋																							
trip	trip	縶馽																							
nrip	nrip	孴{謹慎}																							
drip	drip	蟄																							
tˤimh	t'imh	墊																							
nˤimh	n'imh	念																							
nˤip	n'ip	敜																							
tsˤimh	ts'imh	僭{~越}																							
lˤimʔ	l'imq	簟驔																							
lˤip	l'ip	褶																							
l̥ˤim	lh'im	忝																							
gˤip	g'ip	叶																							
tiw	tiw	周{稠密}輖椆																							
stiwk	stiwk	叔鮛																							
tʰiwk	thiwk	諔琡																							
diwk	diwk	淑																							
tsiw	tsiw	啾揫蘸𡧯																							
tsiwk	tsiwk	顣																							
tsʰiw	tshiw	秋湫楸鰍𨍊鱃萩鶖																							
siwh	siwh	繡{~組}																							
siwk	siwk	肅鏽䃤鱐鷫蟰																							
liw	liw	攸悠{閒適；~~，久遠}浟峳鯈由油䍃櫾繇																							
liwh	liwh	鼬貁																							
liwk	liwk	柚																							
l̥iwk	lhiwk	倏儵虪																							
sliw	sliw	修脩𩛢																							
sliwh	sliwh	滫																							
riw	riw	翏摎漻{~然，謂變化}鏐蟉疁																							
riwh	riwh	鷚雡飂{國名}																							
C.riwk	C.riwk	戮僇																							
giw	giw	虯虬																							
hiw	hiw	收																							
ʔiw	qiw	幽呦泑怮																							
ʔiwʔ	qiwq	黝																							
ʔiwh	qiwh	幼																							
priw	priw	彪																							
briw	briw	淲滮																							
mriw	mriw	繆{絞結；綢~}																							
mriwh	mriwh	謬繆{錯誤}																							
mriwk	mriwk	穆																							
tʰriw	thriw	惆																							
driw	driw	綢稠																							
tsriw	tsriw	甃																							
dzriw	dzriw	愁																							
lriw	lriw	盩𥂕																							
lriwh	lriwh	籀																							
lriwk	lriwk	逐鱁																							
l̥riwk	lhriwk	苖蓫																							
r̥iw	rhiw	瘳																							
kriw	kriw	樛朻																							
kriwʔ	kriwq	糾糺																							
griw	griw	璆																							
tˤiw	t'iw	雕鵰彫琱凋𥮐䘟																							
tˤiwʔ	t'iwq	鳥蔦																							
tˤiwh	t'iwh	弔吊																							
tˤiwk	t'iwk	弔{至；善}																							
tʰˤiwk	th'iwk	倜																							
dˤiw	d'iw	調蜩																							
dˤiwk	d'iwk	踧{~~，平坦}																							
nˤiwʔ	n'iwq	褭																							
nˤiwk	n'iwk	惄愵																							
tsʰˤiwk	tsh'iwk	戚{斧；~施，駝背}慼鏚鼜																							
dzˤiwk	dz'iwk	寂𠴫																							
sˤiw	s'iw	蕭簫瀟蠨橚櫹																							
sˤiwʔ	s'iwq	䃤謏																							
sˤiwh	s'iwh	歗嘯																							
lˤiw	l'iw	條鰷䱔𧌁鞗鋚																							
lˤiwh	l'iwh	蓧{除草農具}																							
lˤiwk	l'iwk	迪篴滌																							
slˤiw	sl'iw	翛																							
slˤiwʔ	sl'iwq	篠																							
l̥ˤiw	lh'iw	蓧{即蓨，羊蹄草}																							
l̥ˤiwk	lh'iwk	蓨																							
rˤiw	r'iw	漻聊廖																							
rˤiwʔ	r'iwq	蓼鄝																							
C.rˤiw	C.r'iw	寥																							
kˤiwh	k'iwh	叫呌訆嘂																							
hˤiw	h'iw	䫞																							
ʔˤiw	q'iw	么幺狕																							
ʔˤiwʔ	q'iwq	鴢																							
ʔˤiwh	q'iwh	穾																							
tˤriw	t'riw	啁																							
kˤriw	k'riw	膠𦫶																							
kʰˤriw	kh'riw	膠{~加，乖戾}																							
hˤriw	h'riw	嘐																							
ʔˤriw	q'riw	坳																							
ʔˤriwʔ	q'riwq	拗																							
pə	py	不坏鴀																							
pəʔ	pyq	否{不}																							
pəh	pyh	富䔰																							
pʰə	phy	紑衃																							
pʰəʔ	phyq	𢜳																							
pʰəh	phyh	副																							
bə	by	芣罘																							
bəʔ	byq	負婦萯偩																							
bəh	byh	伏{孵蛋}																							
mə	my	謀																							
məʔ	myq	母拇踇畝䳇																							
məh	myh	姆																							
tə	ty	之芝																							
təʔ	tyq	止畤芷趾阯沚洔址																							
təh	tyh	志誌識{標記、記住}織{名詞}																							
stə	sty	詩邿																							
stəh	styh	試{任用}弑																							
tʰə	thy	蚩																							
tʰəʔ	thyq	齒																							
tʰəh	thyh	熾幟																							
də	dy	時塒榯蒔鼭旹																							
dəʔ	dyq	恃市																							
dəh	dyh	侍寺																							
nə	ny	而陑栭咡鴯鮞耏胹聏																							
nəʔ	nyq	耳䋙餌洱駬																							
nəh	nyh	珥䎶佴衈刵																							
tsə	tsy	茲兹滋鎡嵫嗞鰦鼒仔{~肩，勝任}孜																							
tsəʔ	tsyq	子耔梓																							
dzə	dzy	慈鶿磁																							
dzəh	dzyh	字孳牸																							
sə	sy	絲思緦																							
səʔ	syq	葸諰𦖷																							
lə	ly	飴詒怡咍貽瓵																							
ləʔ	lyq	以苡佁㠯苢																							
l̥əʔ	lhyq	始枲																							
l̥ə	lhy	司伺																							
l̥əh	lhyh	笥																							
slə	sly	辭祠詞																							
sləʔ	slyq	似鈶枱𤹇姒																							
sləh	slyh	嗣飼																							
rə	ry	釐厘氂漦斄嫠剺梩																							
rəʔ	ryq	里㾖理李裏裡悝俚鯉																							
rəh	ryh	吏																							
C.rə	C.ry	貍狸																							
ɫə	jy	頤熙{廣闊；興盛}圯异顊宧㺿																							
ɫəʔ	jyq	已																							
ɫəh	jyh	異																							
ɫ̥əʔ	jhyq	茝																							
ɫ̥əh	jhyh	𩟄																							
kɫə	kjy	姬																							
mɫəʔ	mjyq	俟涘竢騃巳汜祀耜{起土器}洍戺																							
kə	ky	基箕萁𦮼朞稘																							
kəʔ	kyq	己紀記																							
kʰə	khy	欺倛僛娸																							
kʰəʔ	khyq	起杞屺芑																							
gə	gy	其亓期旗騏騹麒祺琪璂淇䳢鶀棊綦藄碁棋濝鯕																							
gəh	gyh	忌惎誋鵋																							
ŋə	ngy	疑嶷{九~}觺																							
ŋəʔ	ngyq	擬儗薿																							
ŋəh	ngyh	譺																							
hə	hy	熺僖嘻禧譆嬉誒																							
həʔ	hyq	喜憙娭																							
həh	hyh	饎糦																							
kwəʔ	kwyq	久玖灸疚																							
kʰwə	khwy	丘邱蚯																							
gwə	gwy	裘俅莍																							
gwəʔ	gwyq	臼																							
gwəh	gwyh	柩舊																							
ŋwə	ngwy	牛																							
wə	wy	尤肬訧疣郵																							
wəʔ	wyq	有友右祐侑䳑																							
wəh	wyh	又佑宥姷𩑣																							
ʔə	qy	抑{助詞}噫殹醫																							
ʔəʔ	qyq	矣																							
ʔəh	qyh	意{想法}鷾																							
prəʔ	pryq	鄙																							
pʰrə	phry	丕駓銔伾㔻																							
pʰrəʔ	phryq	秠嚭																							
brə	bry	邳䲹魾																							
brəʔ	bryq	岯否{閉塞、困厄}																							
brəh	bryh	備𣖾																							
mrəʔ	mryq	敏𤛎																							
trəʔ	tryq	徵{五音}																							
trəh	tryh	置																							
tʰrəʔ	thryq	祉																							
drə	dry	持荎																							
drəʔ	dryq	峙庤痔跱偫滍																							
drəh	dryh	植值																							
n̥rəʔ	nhryq	恥耻																							
tsrə	tsry	淄緇菑錙輜鶅椔																							
tsrəʔ	tsryq	滓																							
tsrəh	tsryh	胾倳																							
tsʰrəh	tshryh	廁																							
dzrəʔ	dzryq	士仕事{《詩》}																							
dzrəh	dzryh	事																							
srəʔ	sryq	史使駛																							
srəh	sryh	𧳅																							
lrə	lry	治																							
l̥rə	lhry	笞齝																							
l̥rəh	lhryh	眙																							
grə	gry	騏{~驥}																							
kwrə	kwry	龜皸																							
wrəʔ	wryq	洧鮪痏																							
pˤə	p'y	杯桮																							
pʰˤə	ph'y	坯胚阫																							
bˤə	b'y	培陪䣙																							
bˤəʔ	b'yq	倍菩																							
bˤəh	b'yh	佩珮背偝邶																							
mˤə	m'y	莓梅鋂霉媒禖煤膴{法則}																							
mˤəʔ	m'yq	某每痗畮脢																							
mˤəh	m'yh	脄																							
m̥ˤəʔ	mh'yq	海悔𠧩晦賄																							
m̥ˤəh	mh'yh	誨																							
tˤəʔ	t'yq	等																							
tˤəh	t'yh	戴																							
dˤə	d'y	臺																							
dˤəʔ	d'yq	待																							
nˤə	n'y	能																							
nˤəʔ	n'yq	迺乃疓鼐																							
nˤəh	n'yh	能{同“耐”}耐																							
n̥ˤəh	nh'yh	態																							
tsˤə	ts'y	災哉栽烖																							
tsˤəʔ	ts'yq	宰載{年；祀；助詞}																							
tsˤəh	ts'yh	載{記~；開始；成功；施行}再																							
tsʰˤə	tsh'y	偲猜																							
tsʰˤəʔ	tsh'yq	采彩綵採寀㥒																							
tsʰˤəh	tsh'yh	菜䐆																							
dzˤə	dz'y	才材財裁																							
dzˤəʔ	dz'yq	在																							
dzˤəh	dz'yh	載酨																							
sˤəh	s'yh	㥶賽																							
lˤə	l'y	駘菭苔炱																							
lˤəʔ	l'yq	殆怠紿迨䈚箈																							
lˤəh	l'yh	代岱黛玳䒫																							
l̥ˤə	lh'y	台胎邰鮐																							
l̥ˤəh	lh'yh	詒{誒~}貸{借出}																							
rˤə	r'y	來{助詞}萊庲淶騋鯠崍鶆郲																							
rˤəh	r'yh	賚睞																							
C.rˤə	C.r'y	來{過來；將來，過去}																							
C.rˤəh	C.r'yh	來{歸順、招致}徠																							
kɫˤəʔ	kj'yq	改																							
kˤə	k'y	該畡荄賅侅晐胲豥峐陔垓祴																							
kʰˤəʔ	kh'yq	輆肯肎																							
kʰˤəh	kh'yh	欬																							
gˤə	g'y	孩咳豥																							
gˤəʔ	g'yq	亥																							
gˤəh	g'yh	㤥																							
ŋˤəʔ	ng'yq	礙閡																							
ŋˤəh	ng'yh	懝																							
kʰwˤə	khw'y	恢																							
wˤə	w'y	蚘																							
ẘˤə	wh'y	灰䀁																							
ẘˤəʔ	wh'yq	醢																							
ʔˤə	q'y	埃唉欸																							
ʔˤəʔ	q'yq	毐																							
ʔˤəh	q'yh	誒{~詒}																							
bˤrəh	b'ryh	憊																							
mˤrə	m'ry	埋霾薶																							
dzˤrə	dz'ry	豺																							
kˤrə	k'ry	荄																							
kˤrəh	k'ryh	誡戒{準備}																							
gˤrə	g'ry	骸																							
gˤrəʔ	g'ryq	駭絯駴																							
gˤrəh	g'ryh	械																							
ŋˤrəʔ	ng'ryq	癡																							
kwˤrəh	kw'ryh	怪																							
ʔˤrəʔ	q'ryq	挨																							
pək	pyk	福輻幅葍蝠複楅鶝																							
bəŋ	byng	馮{地名}																							
bək	byk	服箙伏茯虙																							
məŋ	myng	夢儚																							
məŋh	myngh	㝱鄸																							
mək	myk	牧坶																							
təŋ	tyng	烝蒸脀																							
təŋh	tyngh	證																							
tək	tyk	騭織{動詞}職樴膱蘵䐈																							
stəŋ	styng	升陞昇																							
stək	styk	識{了解，知~}																							
tʰəŋ	thyng	稱偁																							
dəŋ	dyng	承丞拯抍𨋬																							
dək	dyk	植{直；剛強；種~}殖埴𡑌湜{~~，清澈}寔																							
nəŋ	nyng	陾仍扔艿																							
n̥əŋ	nhyng	勝{戴~}																							
tsəŋh	tsyngh	甑䰝																							
tsək	tsyk	稷																							
dzəŋ	dzyng	橧繒驓鄫																							
sək	syk	息鄎蒠熄																							
ləŋh	lyngh	媵賸䞉鱦																							
lək	lyk	弋芅杙釴黓仂																							
l̥əŋ	lhyng	勝																							
l̥əŋh	lhyngh	榺																							
l̥ək	lhyk	式試{嘗~；比~}拭軾飾																							
mləŋ	mlyng	乘椉憴																							
mləŋh	mlyngh	𣎜																							
mlək	mlyk	食蝕																							
rəŋ	ryng	陵䧙琌凌淩鯪㥄菱蔆䔖																							
C.rək	C.ryk	力朸																							
ɫəŋ	jyng	蠅蝇孕																							
ɫək	jyk	翼瀷																							
mɫəŋ	mjyng	繩澠																							
hɫəŋ	hjyng	興																							
kəŋ	kyng	兢																							
kək	kyk	亟殛悈																							
gək	gyk	極																							
ŋək	ngyk	嶷{幼小聰慧}凝{~~，水凍；嚴酷}																							
ŋ̊ək	nhgyk	赩																							
kwəŋ	kwyng	弓																							
kʰwəŋ	khwyng	穹芎																							
wəŋ	wyng	雄																							
wək	wyk	囿																							
ʔəŋ	qyng	膺應{~該；國名}鷹																							
ʔəŋh	qyngh	應																							
ʔək	qyk	意{意志、念頭}億憶臆肊醷檍薏繶																							
ʔwək	qwyk	彧郁栯																							
prəŋ	pryng	冰掤																							
prək	pryk	逼偪湢																							
pʰrək	phryk	副{割裂、剖分}疈堛揊																							
brəŋ	bryng	馮憑																							
brək	bryk	愎																							
trəŋ	tryng	徵																							
trək	tryk	陟稙																							
tʰrək	thryk	淔																							
drəŋ	dryng	澄懲																							
drək	dryk	直犆																							
nrək	nryk	匿暱																							
n̥rək	nhryk	恜																							
tsrək	tsryk	側萴仄昃																							
tsʰrək	tshryk	測惻畟																							
lrəŋh	lryngh	朕栚																							
l̥rək	lhryk	敕{整飭；治，理}飭侙																							
r̥ək	rhyk	勑{告誡}敕{告誡}																							
srək	sryk	嗇穡薔繬																							
krək	kryk	棘襋蕀																							
ŋrəŋ	ngryng	凝																							
ŋ̊rək	nhgryk	色𨋭																							
wrək	wryk	域緎棫罭																							
ẘrək	whryk	閾窢																							
pˤəŋ	p'yng	崩																							
pˤəŋh	p'yngh	塴																							
pˤək	p'yk	北																							
bˤəŋ	b'yng	朋傰倗鵬																							
bˤək	b'yk	匐僰踣																							
mˤəŋ	m'yng	瞢																							
mˤək	m'yk	墨纆默嘿蟔																							
m̥ˤəŋ	mh'yng	薨{諸侯死；~~，轟轟}𪈘																							
m̥ˤək	mh'yk	黑㱄																							
tˤəŋ	t'yng	登燈簦																							
tˤəŋh	t'yngh	鐙隥																							
tˤək	t'yk	得德{性質；品德}																							
dˤəŋh	d'yngh	鄧																							
dˤək	d'yk	特																							
n̥ˤək	nh'yk	慝																							
tsˤəŋ	ts'yng	曾矰增憎罾竲譄																							
tsˤək	ts'yk	則載{筑牆長版}																							
dzˤəŋ	dz'yng	曾{~經}層																							
dzˤəŋh	dz'yngh	贈																							
dzˤək	dz'yk	賊鰂																							
sˤək	s'yk	塞																							
lˤəŋ	l'yng	滕騰縢鰧謄幐																							
lˤək	l'yk	𧎢蟘螣																							
l̥ˤək	lh'yk	忒貸{借入；同“忒”，變化、差錯}貣																							
rˤəŋ	r'yng	薐																							
rˤək	r'yk	扐阞泐																							
C.rˤək	C.r'yk	來{小麥；勤勞；來（詩經西土）}勒																							
kˤəŋ	k'yng	緪																							
kˤəŋh	k'yngh	堩㮓																							
kʰˤək	kh'yk	刻克剋																							
gˤəŋ	g'yng	恒恆亙姮																							
gˤək	g'yk	劾																							
kwˤəŋ	kw'yng	肱																							
kwˤək	kw'yk	國																							
gwˤəŋ	gw'yng	弘鞃																							
wˤək	w'yk	或蜮惑																							
pˤrəŋ	p'ryng	繃																							
bˤrəŋ	b'ryng	棚																							
mˤrəŋ	m'ryng	甍甿萌{萌發；鋤去；~~，保全、存在}																							
mˤrək	m'ryk	麥																							
kˤrək	k'ryk	革戒{警戒、戒備}愅																							
gˤrək	g'ryk	核																							
kwˤrək	kw'ryk	馘蟈膕																							
gwˤrəŋ	gw'ryng	宏閎紘竑																							
gwˤrək	gw'ryk	鱯																							
ẘˤrək	wh'ryk	繣掝騞																							
pəj	pyj	非飛扉匪{非}𠏿誹																							
pəjʔ	pyjq	餥匪{篚；斐}篚棐𩇹蜰																							
pəs	pys	沸																							
pʰəj	phyj	妃婓菲{~~，香氣盛}騑霏																							
pʰəjʔ	phyjq	菲悱斐朏																							
pʰəs	phys	髴{髣~，隱約}																							
bəj	byj	肥腓𩇯																							
bəjʔ	byjq	痱陫																							
bəjh	byjh	萉蜚翡厞剕䠊屝黂蟦																							
bəs	bys	𥝋狒㵒怫																							
məj	myj	微薇溦癓																							
məjʔ	myjq	尾娓																							
məs	mys	未味沬菋																							
m̥əj	mhyj	徽鰴																							
təj	tyj	祗祁{昭餘~}䓜																							
dəj	dyj	祁{~縣；~~，多、盛；舒緩、和順}祇{神~}																							
nəj	nyj	尼																							
səj	syj	私																							
ləj	lyj	夷姨桋侇																							
ləs	lys	隶殔肄																							
l̥əj	lhyj	尸{神主牌；陳列；楚月名}																							
sləs	slys	肂貄蕼𧳙																							
rəjʔ	ryjq	履																							
rəs	rys	莅蒞																							
kəj	kyj	幾譏璣機饑鞿禨磯刉刏																							
kəjʔ	kyjq	幾穖																							
kəs	kys	既旣蔇旡																							
kʰəjʔ	khyjq	豈																							
kʰəs	khys	氣																							
gəj	gyj	畿蟣圻蚚頎玂𧰙鬿																							
ŋəjʔ	ngyjq	螘顗																							
ŋəs	ngys	毅藙𧅙																							
həj	hyj	希稀晞睎欷豨莃悕鵗																							
həjʔ	hyjq	狶唏																							
həs	hys	氣餼愾忥塈{休息；取}																							
kwəj	kwyj	歸																							
wəj	wyj	韋違圍幃闈湋																							
wəjʔ	wyjq	葦偉韡煒韙𥯤瑋																							
wəjh	wyjh	緯																							
wəs	wys	胃𦝩蝟猬謂渭媦彙																							
ẘəj	whyj	暉楎褘																							
ẘəjʔ	whyjq	虺虫																							
ẘəjh	whyjh	諱芔卉																							
ʔəj	qyj	衣依郼																							
ʔəjʔ	qyjq	扆偯																							
prəj	pryj	悲																							
prəs	prys	轡																							
brəjʔ	bryjq	圮																							
mrəj	mryj	湄郿覹黴																							
mrəjʔ	mryjq	美媺																							
mrəs	mrys	魅𥘯																							
trəj	tryj	胝疷																							
drəj	dryj	坻沶阺貾蚳																							
nrəj	nryj	怩{忸~}																							
nrəjʔ	nryjq	柅																							
lrəj	lryj	遲謘																							
lrəjh	lryjh	稺穉稚																							
krəj	kryj	飢肌机																							
krəjʔ	kryjq	几麂																							
krəjh	kryjh	冀驥覬																							
kʰrəs	khrys	器																							
grəs	grys	塈{以泥塗屋頂}暨鱀																							
kʰwrəj	khwryj	巋																							
kʰwrəs	khwrys	喟																							
gwrəj	gwryj	騤																							
pˤəjh	p'yjh	輩																							
pʰˤəjh	ph'yjh	配																							
bˤəj	b'yj	徘																							
mˤəj	m'yj	枚玫玟																							
mˤəs	m'ys	妹眛																							
m̥ˤəjʔ	mh'yjq	火{《詩》“火”在此，或作“𤈦”}																							
m̥ˤəs	mh'ys	頮靧																							
nˤəj	n'yj	泥																							
nˤəjʔ	n'yjq	泥昵																							
nˤəjh	n'yjh	迡																							
tsˤəj	ts'yj	躋隮																							
tsˤəjʔ	ts'yjq	濟{~~，莊敬、整齊}泲																							
tsˤəjh	ts'yjh	濟{渡河；救助；成就}																							
tsʰˤəj	tsh'yj	妻萋淒凄悽																							
dzˤəj	dz'yj	齊嚌																							
dzˤəjh	dz'yjh	穧																							
sˤəj	s'yj	棲栖																							
lˤəj	l'yj	鵜																							
lˤəjʔ	l'yjq	弟{兄弟（詩經西土）；豈~，和樂平易}悌娣																							
lˤəjh	l'yjh	睇																							
l̥ˤəj	lh'yj	梯																							
l̥ˤəs	lh'ys	曃																							
rˤəj	r'yj	黎黧藜蔾																							
kˤəj	k'yj	剴																							
kˤəs	k'ys	溉概槩摡																							
kʰˤəj	kh'yj	闓開																							
kʰˤəjʔ	kh'yjq	凱塏愷鎧																							
kʰˤəs	kh'ys	慨嘅																							
gˤəs	g'ys	瀣																							
ŋˤəj	ng'yj	敳磑皚																							
kwˤəj	kw'yj	瑰瓌																							
gwˤəs	gw'ys	潰																							
wˤəj	w'yj	回徊迴洄佪																							
wˤəjʔ	w'yjq	匯																							
ʔˤəj	q'yj	哀																							
ʔˤəs	q'ys	愛薆僾曖																							
bˤrəj	b'ryj	排俳																							
mˤrəs	m'rys	𩎟																							
kˤrəj	k'ryj	喈{快；~~，鳥聲、鈴聲、和洽}鶛																							
kʰˤrəj	kh'ryj	揩																							
kʰˤrəjʔ	kh'ryjq	楷鍇																							
gˤrəj	g'ryj	湝{~~，水流貌}諧																							
gˤrəs	g'rys	䪥薤																							
hˤrəs	h'rys	齂																							
kwˤrəj	kw'ryj	乖																							
ẘˤrəs	wh'rys	躗																							
pən	pyn	分昐																							
pənʔ	pynq	粉扮																							
pənh	pynh	奮僨𤘝瀵																							
pət	pyt	笰紼綍																							
pʰən	phyn	紛氛雰翂𢁥帉																							
pʰənʔ	phynq	忿																							
pʰət	phyt	拂茀刜彿																							
bən	byn	蕡墳隫幩轒肦{大頭}枌汾𥦋妢棼鼢羒鳻豶羵鼖𢿠濆棻																							
bənʔ	bynq	弅蚠魵憤膹																							
bənh	bynh	秎																							
bət	byt	咈																							
mən	myn	文紋蚊蟁蚉鳼鴍鼤																							
mənʔ	mynq	抆吻㖧刎呡亹{~~，勤勉；行進}																							
mənh	mynh	汶紊絻脕																							
mət	myt	芴																							
m̥ət	mhyt	忽欻																							
tən	tyn	振震畛																							
tənʔ	tynq	疹軫䡩賑袗眕裖縝鬒稹黰胗																							
stən	styn	娠																							
dən	dyn	慎脣唇辰晨宸麎																							
dənʔ	dynq	蜃脤蜄																							
nən	nyn	刃軔																							
nənʔ	nynq	忍荵涊{水名}																							
nənh	nynh	仞牣訒肕																							
lənʔ	lynq	引靷蚓螾鈏戭夤{脊肉}胤演{濕潤}																							
lənh	lynh	酳																							
l̥ən	lhyn	申伸紳柛䰠																							
l̥ənʔ	lhynq	矧弞哂																							
l̥ənh	lhynh	瞚																							
mlən	mlyn	神																							
rən	ryn	鄰隣麟麐轔驎磷𧲂瞵																							
rənh	rynh	躪甐遴獜																							
C.rən	C.ryn	鱗																							
C.rənh	C.rynh	藺吝																							
kən	kyn	斤釿筋																							
kənʔ	kynq	菫蓳謹槿巹卺																							
kənh	kynh	靳肵																							
kət	kyt	扢訖吃																							
kʰənʔ	khynq	螼																							
kʰət	khyt	芞																							
gən	gyn	旂芹蘄祈慬勤懃																							
gənʔ	gynq	近瘽																							
ŋən	ngyn	沂齦齗䴦																							
ŋənh	ngynh	垽																							
ŋət	ngyt	仡																							
hən	hyn	欣訢昕忻																							
hənh	hynh	焮																							
hət	hyt	汔乞迄汽																							
kwən	kwyn	軍																							
wən	wyn	云芸妘耘紜運鶤員鄖䢵溳																							
wənʔ	wynq	抎𤸫																							
wənh	wynh	暈鄆韗䲰																							
ẘən	whyn	熏{灼燒；~~，和悅}薰勛勳獯翬葷揮輝暉煇纁臐																							
ʔən	qyn	殷慇																							
ʔənʔ	qynq	隱蘟檃讔殷{雷聲}㶏																							
prən	pryn	邠豳汃彬份																							
brən	bryn	貧																							
brət	bryt	佛{~肸}																							
mrən	mryn	閩捪痻㨉抿㡪旻旼䃉碈瑉鴖眉{老}																							
mrənʔ	mrynq	浼{~~，水盛貌}閔憫簢愍暋慜湣脗𨌲																							
m̥rənh	mhrynh	釁舋衅																							
trən	tryn	珍																							
tʰrənʔ	thrynq	辴螴																							
tʰrənh	thrynh	疢																							
drən	dryn	塵診𧭉																							
nrən	nryn	紉																							
nrət	nryt	䵑																							
srən	sryn	詵駪莘																							
lrən	lryn	陳敶																							
lrənʔ	lrynq	朄眹䏖紖絼																							
lrənh	lrynh	陣																							
krən	kryn	巾																							
grən	gryn	矜{威勢；矛柄}																							
grənʔ	grynq	堇墐																							
grənh	grynh	覲饉瑾僅殣廑																							
ŋrən	ngryn	垠銀狺誾泿鄞圁																							
ŋrənh	ngrynh	憖猌																							
hrət	hryt	肸{~蠁}																							
gwrət	gwryt	屈{狂~}																							
wrən	wryn	縜																							
wrənʔ	wrynq	隕損殞磒霣																							
pˤən	p'yn	䴅																							
pʰˤən	ph'yn	噴																							
pʰˤənh	ph'ynh	湓																							
bˤən	b'yn	盆葐																							
bˤənʔ	b'ynq	獖																							
bˤənh	b'ynh	坌																							
bˤət	b'yt	勃浡渤艴𩣡																							
mˤən	m'yn	門捫亹虋𧄸䫒穈																							
mˤənʔ	m'ynq	懣																							
mˤənh	m'ynh	悶																							
m̥ˤən	mh'yn	閽																							
m̥ˤət	mh'yt	笏曶匫																							
tˤənʔ	t'ynq	典																							
tʰˤənʔ	th'ynq	腆																							
tʰˤət	th'yt	餮																							
dˤən	d'yn	臀																							
dˤənʔ	d'ynq	殄沴																							
dˤənh	d'ynh	殿澱																							
nˤən	n'yn	撚																							
nˤənh	n'ynh	晛																							
tsˤənh	ts'ynh	薦																							
dzˤən	dz'yn	存𨚲																							
dzˤənh	dz'ynh	荐洊栫袸																							
sˤən	s'yn	西先																							
sˤənʔ	s'ynq	洒銑洗跣姺毨																							
l̥ˤən	lh'yn	吞																							
kˤən	k'yn	根																							
kˤənh	k'ynh	艮																							
kʰˤənʔ	kh'ynq	墾豤																							
gˤən	g'yn	鞎痕																							
gˤənʔ	g'ynq	很狠佷																							
gˤənh	g'ynh	恨																							
gˤət	g'yt	齕紇																							
kwˤənʔ	kw'ynq	緷																							
kwˤət	kw'yt	汩骨滑{治；亂；~稽}蓇鶻																							
gwˤən	gw'yn	渾																							
gwˤət	gw'yt	抇搰																							
wˤən	w'yn	魂䮝沄																							
ẘˤən	wh'yn	𤟤																							
ʔˤən	q'yn	恩																							
pʰˤrən	ph'ryn	盼																							
kˤrən	k'ryn	艱																							
kˤrət	k'ryt	鞂																							
gˤrən	g'ryn	蛝																							
gˤrənʔ	g'rynq	限																							
ŋˤrənʔ	ng'rynq	眼																							
kwˤrən	kw'ryn	鰥																							
gwˤrət	gw'ryt	猾滑䱻螖																							
ʔˤrən	q'ryn	殷{深紅}																							
pəm	pym	風楓																							
pəmh	pymh	諷																							
bəm	bym	鳳渢芃																							
təm	tym	斟																							
təmʔ	tymq	枕䪴																							
tʰəmʔ	thymq	瀋																							
dəm	dym	煁{爐}葚湛{河名}																							
nəm	nym	壬任衽紝恁																							
nəmʔ	nymq	荏{白蘇；軟}𦷺飪																							
nəmh	nymh	絍																							
nəp	nyp	入																							
tsəm	tsym	祲																							
tsəmʔ	tsymq	寖																							
tsəmh	tsymh	浸																							
tsəp	tsyp	㗱																							
tsʰəm	tshym	侵綅浸{~淫，濡染}																							
tsʰəmʔ	tshymq	梫																							
tsʰəmh	tshymh	沁																							
tsʰəp	tshyp	緝葺																							
dzəm	dzym	鬵																							
dzəp	dzyp	集輯																							
səm	sym	心																							
ləm	lym	淫鐔鷣																							
ləp	lyp	熠																							
l̥əmʔ	lhymq	審瞫曋㜤																							
l̥əp	lhyp	溼濕䏉																							
sləm	slym	尋鄩																							
sləp	slyp	習謵槢騽𪄶襲隰鰼																							
rəm	rym	林淋琳霖																							
rəmʔ	rymq	懍懔廩菻																							
rəp	ryp	立苙鴗																							
C.rəp	C.ryp	笠粒																							
kəm	kym	金汵𪑙																							
kəp	kyp	給芨汲{打水；~~，急切}伋{思考敏捷}觙級急																							
kʰəm	khym	欽衾嶔																							
kʰəmʔ	khymq	坅																							
gəm	gym	琴芩靲耹庈黔黚																							
gəmh	gymh	紟																							
ŋəm	ngym	岑																							
həm	hym	歆廞																							
həp	hyp	翕歙潝闟吸																							
wəm	wym	熊																							
wəp	wyp	昱翌																							
ʔəm	qym	音𪳀																							
ʔəmʔ	qymq	喑																							
ʔəp	qyp	邑悒																							
prəmʔ	prymq	稟																							
prəp	pryp	鴔{鵖~}																							
pʰrəmʔ	phrymq	品																							
brəp	bryp	鵖{~鴔}																							
trəm	trym	椹																							
trəmh	trymh	揕																							
tʰrəmʔ	thrymq	趻鍖																							
drəm	drym	鈂																							
drəmh	drymh	鴆																							
nrəm	nrym	鵀																							
nrəmh	nrymh	賃																							
tsrəm	tsrym	譖簪																							
tsrəp	tsryp	戢濈																							
tsʰrəm	tshrym	僭{差失；虛僞}																							
tsʰrəmh	tshrymh	讖																							
dzrəm	dzrym	涔																							
dzrəp	dzryp	䯂																							
srəm	srym	槮森㺑																							
srəp	sryp	歰翜																							
lrəm	lrym	莐𧂇																							
l̥rəm	lhrym	闖琛																							
r̥əm	rhym	綝郴																							
krəm	krym	禁襟衿																							
kʰrəp	khryp	泣湆																							
grəp	gryp	及鷑																							
ŋrəm	ngrym	唫吟																							
ŋrəp	ngryp	圾岌																							
tˤəm	t'ym	眈酖妉湛{喜樂}																							
tˤəmʔ	t'ymq	黕																							
tˤəp	t'yp	答荅畣																							
tʰˤəmʔ	th'ymq	醓黮																							
tʰˤəp	th'yp	嗒																							
dˤəmʔ	d'ymq	髧																							
nˤəm	n'ym	南男楠柟{同“楠”}枏																							
nˤəp	n'yp	納軜靹䪏																							
tsˤəm	ts'ym	鐕																							
tsˤəmʔ	ts'ymq	寁																							
tsˤəp	ts'yp	噆帀																							
tsʰˤəm	tsh'ym	慘																							
tsʰˤəmʔ	tsh'ymq	憯																							
dzˤəm	dz'ym	蠶																							
dzˤəp	dz'yp	雜																							
sˤəm	s'ym	蔘毿																							
sˤəmʔ	s'ymq	糝糂																							
sˤəp	s'yp	颯卅																							
lˤəm	l'ym	覃潭蟫譚藫																							
lˤəmʔ	l'ymq	禫窞萏																							
lˤəp	l'yp	沓遝誻讋{~諄，中民亂}慴曡疊譶																							
l̥ˤəmʔ	lh'ymq	嗿																							
l̥ˤəmh	lh'ymh	探																							
l̥ˤəp	lh'yp	踏嚃濕{水名，同“漯”}漯																							
slˤəp	sl'yp	鈒																							
rˤəm	r'ym	惏婪																							
rˤəp	r'yp	搚																							
kˤəm	k'ym	雂蜬																							
kˤəmʔ	k'ymq	感鱤贛{水名}㔶𧆐																							
kˤəmh	k'ymh	詌																							
kˤəp	k'yp	鴿蛤𧊧㪉韐閤鮯頜佮㠷																							
kʰˤəm	kh'ym	堪龕戡																							
kʰˤəmʔ	kh'ymq	坎埳欿顑戇																							
kʰˤəmh	kh'ymh	勘																							
kʰˤəp	kh'yp	溘厒																							
gˤəm	g'ym	含函涵蜭顄䶃																							
gˤəmʔ	g'ymq	竷菡頷撼																							
gˤəmh	g'ymh	唅憾																							
gˤəp	g'yp	合郃																							
ŋˤəm	ng'ym	嵁																							
ŋˤəp	ng'yp	馺{~遝，連續不斷}																							
hˤəm	h'ym	欦																							
ʔˤəm	q'ym	韽鵪																							
ʔˤəp	q'yp	唈姶罨																							
dzˤrəmʔ	dz'rymq	瀺																							
sˤrəm	s'rym	摻																							
kˤrəm	k'rym	玪瑊緘椷																							
kˤrəmʔ	k'rymq	減																							
kˤrəp	k'ryp	鞈𩊆																							
kʰˤrəp	kh'ryp	䁍																							
gˤrəm	g'rym	咸諴鹹醎																							
gˤrəmh	g'rymh	陷䱤錎閻																							
gˤrəp	g'ryp	洽祫																							
ŋˤrəm	ng'rym	羬麙碞																							
ʔˤrəp	q'ryp	凹䆟																							
po	po	跗柎𩿧																							
poʔ	poq	府俯俛{同“俯”}腑																							
poh	poh	付軵																							
pʰo	pho	泭																							
pʰoʔ	phoq	弣																							
pʰoh	phoh	赴拊仆訃																							
bo	bo	鳧符苻																							
boʔ	boq	附腐胕坿																							
boh	boh	鮒祔蚹駙附{親~}																							
mo	mo	瞴																							
moʔ	moq	侮																							
moh	moh	騖務霧婺𦎦																							
to	to	朱珠侏祩鴸硃																							
toʔ	toq	主枓麈																							
toh	toh	注紸殶澍㹥																							
tʰo	tho	姝樞{門的轉軸；~紐}																							
do	do	殳銖殊洙茱{~萸}																							
doʔ	doq	樹豎竪																							
no	no	濡儒繻襦鱬懦偄懧臑㼱																							
noʔ	noq	醹乳																							
noh	noh	孺擩{染}㨎																							
n̥oh	nhoh	戍																							
sno	sno	需緰鑐嬬𪋐																							
tso	tso	諏娵																							
tsʰo	tsho	趨																							
tsʰoʔ	tshoq	取																							
tsʰoh	tshoh	趣娶																							
dzoʔ	dzoq	聚																							
so	so	須鬚嬃𩓣																							
lo	lo	俞愉逾瑜踰渝揄{揮動}榆羭蕍蝓窬{同“踰”}覦螸																							
loʔ	loq	瘉愈貐																							
loh	loh	喻諭籲																							
l̥o	lho	輸																							
l̥oh	lhoh	隃腧䩱																							
ro	ro	婁摟鷜漊																							
roʔ	roq	僂縷𧃒																							
roh	roh	屢																							
ɫo	jo	臾腴萸{茱~}諛																							
ɫoʔ	joq	窳楰庾斔瘐斞裕																							
ko	ko	拘駒跔痀捄{盛土於器}俱																							
koʔ	koq	枸椇																							
koh	koh	句{~子}泃																							
kʰo	kho	軀𨈳驅區敺嶇																							
kʰoʔ	khoq	竘																							
go	go	絇劬翑姁鼩斪鴝朐葋軥																							
goh	goh	具																							
ŋo	ngo	禺愚隅嵎喁腢																							
ŋoʔ	ngoq	寓																							
ŋoh	ngoh	遇																							
hoʔ	hoq	煦休{燠~，痛聲}䧁																							
hoh	hoh	酗呴昫																							
ʔoʔ	qoq	傴饇																							
ʔoh	qoh	飫嫗																							
tro	tro	株誅跦邾鴸袾蛛鼄𧑤																							
troʔ	troq	拄																							
troh	troh	住鉒駐																							
tʰro	thro	貙																							
dro	dro	趎廚躕																							
droʔ	droq	柱砫																							
tsʰro	tshro	芻蒭犓																							
dzro	dzro	雛鶵																							
sroʔ	sroq	數藪棷{同“藪”}籔																							
kroh	kroh	屨																							
groʔ	groq	窶貗																							
pˤoʔ	p'oq	掊{擊}																							
pʰˤoʔ	ph'oq	剖棓																							
bˤo	b'o	抔掊{扒開、搜取}箁																							
bˤoʔ	b'oq	部蔀瓿																							
mˤo	m'o	鍪蝥𩭾																							
mˤoh	m'oh	懋袤愗{怐~，愚昧}䓮																							
tˤo	t'o	兜																							
tˤoʔ	t'oq	斗㪷																							
tˤoh	t'oh	鬬鬭闘鬥																							
tʰˤoʔ	th'oq	黈																							
tʰˤoh	th'oh	㰯																							
dˤo	d'o	投頭																							
dˤoʔ	d'oq	𨪐																							
dˤoh	d'oh	豆脰浢逗																							
nˤo	n'o	獳																							
nˤoh	n'oh	鎒																							
tsˤo	ts'o	掫																							
tsˤoʔ	ts'oq	走奏																							
tsʰˤoh	tsh'oh	輳腠湊																							
sˤoʔ	s'oq	嗾																							
sˤoh	s'oh	欶嗽																							
lˤo	l'o	歈																							
lˤoh	l'oh	竇{同“竇”}窬																							
l̥ˤo	lh'o	偷媮																							
rˤo	r'o	蔞膢鞻髏																							
rˤoʔ	r'oq	螻																							
rˤoh	r'oh	漏陋瘻鏤																							
C.rˤo	C.r'o	樓																							
kˤo	k'o	句{彎曲}勾鉤鈎枸{彎曲、盤錯}緱																							
kˤoʔ	k'oq	苟笱耇耈狗垢																							
kˤoh	k'oh	彀雊姤㝅																							
kʰˤo	kh'o	彄摳																							
kʰˤoʔ	kh'oq	釦叩扣																							
kʰˤoh	kh'oh	寇鷇袧怐{~愗，愚昧}																							
gˤo	g'o	侯鍭𦞈猴喉鄇瘊翭篌																							
gˤoʔ	g'oq	後郈																							
gˤoh	g'oh	候餱																							
ŋˤo	ng'o	齵																							
ŋˤoʔ	ng'oq	偶耦藕																							
hˤoʔ	h'oq	蚼																							
hˤoh	h'oh	訽詬																							
ʔˤo	q'o	區{量器}歐甌嘔{~夷}謳鏂䳼熰樞{刺榆}藲鷗																							
ʔˤoʔ	q'oq	毆嘔{~吐}																							
ʔˤoh	q'oh	漚																							
bˤro	b'ro	捊																							
mˤro	m'ro	蟊																							
tˤroh	t'roh	晝咮{鳥喙；柳宿}噣{鳥喙；畢宿}																							
tsˤro	ts'ro	鄒騶𨃘棸陬緅郰鄹菆棷{木名}																							
tsˤroʔ	ts'roq	掫																							
tsˤroh	ts'roh	縐																							
tsʰˤroʔ	tsh'roq	𩋄																							
dzˤroh	dz'roh	驟																							
sˤroʔ	s'roq	盨																							
sˤroh	s'roh	漱																							
kˤro	k'ro	冓溝篝韝																							
kˤroʔ	k'roq	茩																							
kˤroh	k'roh	媾覯遘搆構購																							
kʰˤroʔ	kh'roq	口																							
kʰˤroh	kh'roh	詬{喫~，強壯}滱																							
gˤroʔ	g'roq	后厚缿																							
gˤroh	g'roh	逅																							
ʔˤro	q'ro	嘔{唲~}																							
poŋ	pong	封葑																							
pʰoŋ	phong	丰鋒烽蜂𧒒蠭峰峯																							
pʰoŋʔ	phongq	捧																							
boŋ	bong	逢縫夆漨																							
boŋʔ	bongq	奉																							
boŋh	bongh	俸																							
m̥ok	mhok	勖勗																							
toŋ	tong	鍾鐘籦妐																							
toŋʔ	tongq	種腫踵																							
tok	tok	屬燭灟矚馵																							
stoŋ	stong	舂																							
stok	stok	束																							
tʰoŋ	thong	衝憧罿𠟍																							
tʰok	thok	觸歜斶臅觕																							
doŋʔ	dongq	尰																							
dok	dok	屬{種類；附~；親~}蜀蠋襡																							
noŋ	nong	茸襛穠																							
noŋʔ	nongq	冗宂氄																							
nok	nok	辱溽蓐鄏𪑾縟																							
tsoŋ	tsong	蹤從{直，~橫}縱																							
tsok	tsok	足哫																							
tsʰoŋ	tshong	從{~容}樅																							
dzoŋ	dzong	從{隨~}																							
dzoŋh	dzongh	從{放~；~者}																							
soŋ	song	蜙																							
soŋʔ	songq	竦聳悚駷																							
sok	sok	涑																							
loŋ	long	用庸墉鏞傭{僱~}滽鱅鄘䗤																							
loŋʔ	longq	甬勇踊踴蛹俑涌湧𧗴																							
l̥ok	lhok	粟																							
sloŋh	slongh	誦																							
slok	slok	續藚																							
mloŋ	mlong	鱅																							
mlok	mlok	贖																							
roŋ	rong	壟籠{籦~}壠																							
roŋʔ	rongq	隴																							
rok	rok	錄綠菉騄																							
C.roŋ	C.rong	龍																							
ɫoŋ	jong	容頌蓉溶{~㵝}鎔																							
ɫok	jok	欲慾浴鵒鋊																							
mɫoŋ	mjong	松訟鬆																							
mɫok	mjok	俗																							
koŋ	kong	供																							
koŋʔ	kongq	鞏栱拲蛬																							
kok	kok	輂䡞挶梮																							
kʰoŋ	khong	銎																							
kʰoŋʔ	khongq	恐																							
kʰok	khok	曲																							
goŋ	gong	邛卭輁蛩																							
gok	gok	局																							
ŋoŋ	ngong	顒鰅																							
ŋok	ngok	玉																							
ŋ̊ok	nhgok	頊																							
hoŋ	hong	凶兇𣧑訩匈洶汹哅胷胸																							
hok	hok	旭																							
ʔoŋ	qong	雍噰澭邕雝灉壅饔𢋊廱癰癕𧴗																							
ʔoŋʔ	qongq	擁臃																							
troŋʔ	trongq	冢塚																							
trok	trok	斸欘钃瘃																							
tʰrok	throk	梀																							
droŋ	drong	重{~疊}穜																							
droŋʔ	drongq	重{厚~}衶																							
drok	drok	躅䠱																							
nroŋ	nrong	醲																							
tsrok	tsrok	捉																							
tsʰroŋ	tshrong	囪窗鏦																							
dzrok	dzrok	浞																							
sroŋ	srong	雙																							
lroŋʔ	lrongq	鮦																							
l̥roŋ	lhrong	傭{公平}																							
r̥oŋʔ	rhongq	寵																							
kroŋ	krong	共恭龔																							
kroŋʔ	krongq	拱																							
grok	grok	跼																							
ŋrok	ngrok	獄																							
pˤoŋʔ	p'ongq	菶唪琫鞛䋽																							
pˤok	p'ok	樸{未加工的木材}濮卜鳪纀蹼																							
pʰˤok	ph'ok	撲扑																							
bˤoŋ	b'ong	逢{~~，鼓聲}蓬塳塜																							
bˤok	b'ok	僕																							
mˤoŋ	m'ong	蒙矇幪蠓冡髳饛																							
mˤoŋʔ	m'ongq	蠓																							
mˤoŋh	m'ongh	懞																							
mˤok	m'ok	木蚞霂沐鶩楘																							
tˤoŋ	t'ong	東凍蝀																							
tˤoŋʔ	t'ongq	蕫董																							
tˤoŋh	t'ongh	棟䍶湩涷																							
tʰˤoŋ	th'ong	畽																							
dˤoŋ	d'ong	童僮瞳犝潼																							
dˤoŋʔ	d'ongq	動																							
dˤoŋh	d'ongh	慟																							
dˤok	d'ok	獨𤠢罜鸀韣髑𪇆																							
nˤoŋ	n'ong	膿濃																							
nˤok	n'ok	耨																							
tsˤoŋ	ts'ong	豵椶翪猣朡惾緵稯艐																							
tsˤoŋʔ	ts'ongq	總緫鬷摠揔蓯𢊕																							
tsˤok	ts'ok	鏃																							
tsʰˤoŋ	tsh'ong	聰葱蔥怱																							
tsʰˤoŋh	tsh'ongh	憁																							
tsʰˤok	tsh'ok	蔟瘯																							
dzˤoŋ	dz'ong	叢䕺藂																							
dzˤok	dz'ok	族																							
sˤoŋh	s'ongh	送																							
sˤok	s'ok	速遫趚樕餗蔌遬藗㯈觫																							
lˤoŋ	l'ong	同桐銅峒侗{共同；幼稚}秱筩																							
lˤoŋʔ	l'ongq	洞桶																							
lˤoŋh	l'ongh	筒衕恫{憁~}																							
lˤok	l'ok	瀆犢牘讀讟櫝覿䢱殰黷匵豄韇𦢌嬻																							
l̥ˤoŋ	lh'ong	通恫狪																							
l̥ˤoŋʔ	lh'ongq	侗{長大、通達無掛礙}																							
l̥ˤoŋh	lh'ongh	痛																							
l̥ˤok	lh'ok	禿																							
rˤoŋ	r'ong	礱蘢櫳嚨聾籠蠪																							
rˤoŋʔ	r'ongq	弄																							
rˤok	r'ok	鹿漉淥麓蔍螰摝祿禄琭睩盝																							
kɫˤoŋ	kj'ong	公																							
kɫˤok	kj'ok	谷𤞞																							
kˤoŋ	k'ong	工功攻釭																							
kˤoŋh	k'ongh	貢贛{同“貢”，端木賜之字}																							
kˤok	k'ok	穀榖轂																							
kʰˤoŋ	kh'ong	空悾崆																							
kʰˤoŋʔ	kh'ongq	孔																							
kʰˤoŋh	kh'ongh	控																							
kʰˤok	kh'ok	哭䵈䍍𪍠																							
gˤoŋ	g'ong	訌紅虹𧈫洪洚鴻																							
gˤoŋh	g'ongh	鬨																							
gˤok	g'ok	斛縠觳{同“斛”}螜																							
hˤoŋ	h'ong	烘																							
hˤok	h'ok	豰㺉																							
ʔˤoŋ	q'ong	翁																							
ʔˤoŋʔ	q'ongq	蓊																							
ʔˤoŋh	q'ongh	罋甕瓮																							
ʔˤok	q'ok	屋																							
pˤroŋ	p'rong	邦																							
pˤrok	p'rok	剝																							
pʰˤrok	ph'rok	朴樸{棫~；~樕，小木}璞墣攴																							
bˤroŋ	b'rong	龐逢{姓}逄胮																							
bˤroŋʔ	b'rongq	玤𢈦蚌䰷																							
mˤroŋ	m'rong	尨厖庬哤蛖駹																							
tˤroŋ	t'rong	樁																							
tˤrok	t'rok	琢{雕刻；挑選}啄噣椓涿諑斀斲斵																							
tʰˤroŋ	th'rong	憃																							
tʰˤrok	th'rok	擉																							
dˤroŋ	d'rong	橦幢撞																							
dˤrok	d'rok	濁鐲																							
dzˤrok	dz'rok	齺鷟																							
kˤroŋ	k'rong	江杠矼																							
kˤroŋʔ	k'rongq	講港																							
kˤrok	k'rok	角桷瑴珏斠																							
kʰˤroŋ	kh'rong	跫椌																							
kʰˤrok	kh'rok	愨慤觳埆殼																							
gˤroŋʔ	g'rongq	項																							
gˤroŋh	g'rongh	衖闀巷																							
gˤrok	g'rok	确																							
ŋˤrok	ng'rok	鸑嶽岳																							
hˤroŋ	h'rong	舡																							
ʔˤrok	q'rok	渥喔握幄腛																							
pʰos	phos	杮																							
bos	bos	吠鼣																							
tojʔ	tojq	箠捶棰																							
tos	tos	贅																							
doj	doj	垂厜{~㕒，山頂}倕陲𨹫																							
dojʔ	dojq	菙																							
dojh	dojh	睡																							
nojʔ	nojq	繠蘂蕊																							
nos	nos	蚋																							
n̥ojh	nhojh	挼																							
tsʰos	tshos	脃脆毳膬竁																							
lojʔ	lojq	䝐㨊																							
los	los	銳																							
l̥os	lhos	說{遊~；停止}帨稅涚裞祱喙餯																							
l̥oj	lhoj	墮{毀壞；輸送}綏{祭}隳䜐																							
slojʔ	slojq	髓瀡																							
sloj	sloj	隨																							
rojʔ	rojq	累絫樏																							
C.roj	C.roj	羸																							
ɫ̥oj	jhoj	吹炊																							
kojʔ	kojq	蛫佹詭祪垝姽觤恑																							
gojʔ	gojq	跪䣀																							
ŋoj	ngoj	危峗洈㕒																							
ŋojʔ	ngojq	頠																							
ʔoj	qoj	萎倭																							
ʔojʔ	qojq	委																							
ʔojh	qojh	踒																							
trojh	trojh	諈																							
tros	tros	綴錣餟娺																							
droj	droj	錘膇																							
drojh	drojh	甀硾縋																							
nrojh	nrojh	諉																							
tsʰroj	tshroj	衰{差別、次第；衰減}																							
pˤos	p'os	沛芾{官服上的蔽膝}𨙶																							
bˤos	b'os	拔{盡；茂盛}																							
tˤoj	t'oj	𨹄																							
tˤojʔ	t'ojq	朵埵𦀉																							
tˤos	t'os	祋																							
tʰˤojh	th'ojh	唾																							
n̥ˤojʔ	nh'ojq	妥																							
tsˤoj	ts'oj	挫㛗侳																							
tsˤojh	ts'ojh	蓌																							
tsˤos	ts'os	最																							
tsʰˤoj	tsh'oj	剉																							
tsʰˤojʔ	tsh'ojq	脞																							
tsʰˤos	tsh'os	竄																							
dzˤoj	dz'oj	痤																							
dzˤojʔ	dz'ojq	坐																							
dzˤojh	dz'ojh	座																							
dzˤos	dz'os	蕞																							
sˤoj	s'oj	蓑																							
sˤojʔ	s'ojq	鎖瑣																							
lˤojʔ	l'ojq	惰墮{同“惰”}墯嶞鬌嫷𨬍䲊																							
lˤos	l'os	兌																							
l̥ˤojʔ	lh'ojq	隋橢㯐																							
l̥ˤojh	lh'ojh	毤																							
l̥ˤos	lh'os	駾蛻																							
rˤoj	r'oj	騾蔂鸁																							
rˤojʔ	r'ojq	蓏㒩攭臝裸倮																							
C.rˤoj	C.r'oj	蠃																							
kˤoj	k'oj	戈鍋																							
kˤojʔ	k'ojq	果菓裹蜾																							
kˤos	k'os	鄶澮																							
kʰˤoj	kh'oj	科課																							
kʰˤojʔ	kh'ojq	顆																							
gˤoj	g'oj	禾和龢																							
ŋˤojh	ng'ojh	臥																							
ʔˤoj	q'oj	涹																							
ʔˤos	q'os	薈																							
pˤros	p'ros	拜																							
tsˤroj	ts'roj	髽																							
tsʰˤros	tsh'ros	嘬																							
l̥ˤros	lh'ros	脫{舒適、舒緩}																							
kˤroj	k'roj	騧																							
kʰˤros	kh'ros	噲																							
gˤrojʔ	g'rojq	踝髁輠																							
tor	tor	顓篿																							
torʔ	torq	剸剬																							
dorʔ	dorq	瑞																							
tˤor	t'or	端耑																							
tˤorʔ	t'orq	短揣朵{~頤}																							
tʰˤor	th'or	貒湍																							
tsˤor	ts'or	鑽攅																							
pot	pot	髮紱帗																							
bonʔ	bonq	飯																							
bonh	bonh	飰																							
mon	mon	輓樠																							
monʔ	monq	挽																							
mot	mot	襪韤																							
ton	ton	專膞塼鄟{鄭國城門名}諯																							
tonh	tonh	惴																							
tʰonʔ	thonq	喘																							
tʰot	thot	歠																							
don	don	輲遄歂																							
donʔ	donq	鱄鄟{國名}腨																							
dot	dot	啜嚽																							
non	non	瓀擩{~祭}壖堧																							
nonʔ	nonq	耎輭軟蝡礝																							
not	not	焫吶爇																							
tson	tson	鐫																							
tsot	tsot	蕝																							
tsʰon	tshon	銓荃痊駩悛																							
tsʰonh	tshonh	縓																							
dzon	dzon	全牷																							
dzonʔ	dzonq	雋																							
dzot	dzot	絶絕㡭																							
sonʔ	sonq	選																							
sonh	sonh	䠣																							
sot	sot	雪																							
lon	lon	鳶蝝緣																							
lot	lot	閱悅																							
l̥ot	lhot	說																							
ron	ron	攣癵																							
ronʔ	ronq	臠孌																							
ronh	ronh	戀																							
rot	rot	埒蛶鋝脟																							
C.ronʔ	C.ronq	孌																							
ɫon	jon	沿鉛鈆																							
ɫonʔ	jonq	兖兗萒沇																							
ɫ̥on	jhon	穿																							
mɫon	mjon	船																							
konh	konh	倦帣																							
kot	kot	蕨嶡𠎮獗瘚掘																							
kʰonʔ	khonq	裷																							
kʰonh	khonh	券																							
gonʔ	gonq	圈錈																							
got	got	鷢𩪗																							
ŋon	ngon	元沅芫黿杬阮邧蚖螈嫄騵獂羱榞																							
ŋonh	ngonh	願𩕾																							
ŋot	ngot	軏䡇																							
ʔon	qon	冤寃蒬苑宛{楚地}鴛																							
ʔonʔ	qonq	菀婉宛𪂧綩																							
ʔonh	qonh	怨涴																							
ʔot	qot	黦𧯡																							
pronh	pronh	變																							
bronh	bronh	卞弁抃笲拚																							
tronʔ	tronq	轉																							
trot	trot	掇{短}惙輟畷剟																							
dron	dron	傳																							
dronʔ	dronq	縳																							
tsron	tsron	跧																							
dzronʔ	dzronq	僎{同“撰”}撰																							
dzronh	dzronh	饌籑譔輇																							
sron	sron	𨏉																							
lron	lron	椽																							
lronʔ	lronq	瑑篆																							
l̥ronh	lhronh	鶨																							
kron	kron	勌																							
kronʔ	kronq	卷菤																							
kronh	kronh	眷睠韏桊飬																							
krot	krot	罬																							
kʰron	khron	卷{冠~，帽緣}棬弮																							
kʰronʔ	khronq	綣																							
gron	gron	拳惓踡卷{彎曲；柔弱}捲蜷犈顴																							
gronʔ	gronq	蔨																							
pˤot	p'ot	胈																							
bˤot	b'ot	犮跋																							
tˤon	t'on	竱																							
tˤonʔ	t'onq	斷																							
tˤonh	t'onh	段鍛碫{或訛作“碬”}碬{“碫”之訛字}煅腶踹																							
tˤot	t'ot	掇{拾取}鵽																							
tʰˤon	th'on	䵎																							
dˤon	d'on	團慱漙摶鷒鷻敦																							
dˤonh	d'onh	椴																							
nˤonʔ	n'onq	煗渜餪稬																							
tsˤonʔ	ts'onq	纂臇纘酇																							
tsˤot	ts'ot	繓																							
tsʰˤonh	tsh'onh	爨{楚曆十一月}																							
tsʰˤot	tsh'ot	撮																							
dzˤon	dz'on	欑櫕巑																							
dzˤonh	dz'onh	攢																							
sˤon	s'on	酸痠狻																							
sˤonʔ	s'onq	算篹匴																							
sˤonh	s'onh	筭蒜巽																							
lˤot	l'ot	奪𡙸鮵挩痥																							
l̥ˤonh	lh'onh	彖褖																							
l̥ˤot	lh'ot	脫侻梲莌																							
rˤon	r'on	羉巒灓鑾																							
rˤonh	r'onh	亂																							
rˤot	r'ot	捋																							
C.rˤon	C.r'on	欒孿鸞																							
C.rˤonʔ	C.r'onq	卵																							
kɫˤon	kj'on	貫毌																							
kɫˤonh	kj'onh	實{見《易·象傳》}																							
kˤon	k'on	冠莞棺																							
kˤonʔ	k'onq	盥筦管{管狀物；專管}																							
kˤonh	k'onh	館灌祼罐																							
kˤot	k'ot	劊																							
kʰˤonʔ	kh'onq	款窾																							
kʰˤot	kh'ot	闊{契~，勤苦}																							
gˤon	g'on	完垸																							
gˤonʔ	g'onq	浣澣魭梡睆{渾圓}																							
ŋˤon	ng'on	刓园抏忨岏																							
ŋˤonʔ	ng'onq	輐{~斷，圓轉無棱角}																							
ŋˤonh	ng'onh	翫玩																							
bˤrot	b'rot	拔																							
mˤron	m'ron	蠻																							
tsʰˤronh	tsh'ronh	篡																							
sˤrot	s'rot	刷																							
kˤron	k'ron	關																							
kˤronh	k'ronh	串慣丱卝																							
gˤron	g'ron	患䍺脘																							
gˤronʔ	g'ronq	睆{光滑、明亮}鯇皖																							
gˤronh	g'ronh	豢																							
ŋˤron	ng'ron	頑																							
ŋˤronh	ng'ronh	薍																							
ŋˤrot	ng'rot	刖																							
puʔ	puq	缶缹																							
puh	puh	鍑																							
pʰu	phu	孚莩郛俘稃垺																							
pʰuh	phuh	覆{~蓋、遍及}																							
bu	bu	浮罦蜉烰琈桴枹{鼓槌；术}																							
buʔ	buq	阜蛗𩢿																							
buh	buh	復{反~；回~}覆{埋伏}椱																							
mu	mu	牟侔鴾眸蛑麰雺恈																							
muʔ	muq	牡戊茂楙																							
muh	muh	貿																							
tu	tu	周{周圍、環繞；~章，回旋舒緩}賙舟州洲週婤{~姶，人名}																							
tuʔ	tuq	帚箒鯞																							
stu	stu	收{車后橫木}																							
stuʔ	stuq	守狩																							
tʰu	thu	犨犫臭																							
tʰuʔ	thuq	糗魗																							
stʰuʔ	sthuq	獸																							
du	du	雔讎讐醻酬																							
duʔ	duq	壽受綬																							
duh	duh	授售																							
nu	nu	柔蹂蝚揉騥鶔㹛																							
nuʔ	nuq	葇輮楺沑																							
nuh	nuh	鞣																							
n̥uʔ	nhuq	手																							
snu	snu	羞																							
tsu	tsu	遒																							
tsuʔ	tsuq	酒																							
tsuh	tsuh	僦																							
tsʰu	tshu	蟗緧𪓰																							
dzu	dzu	酋遒鰌蝤{~蠐}慒𧤕																							
dzuʔ	dzuq	就																							
suʔ	suq	糔																							
lu	lu	由{動植物名；~~，愉悅}悠{~~，憂思貌}滺舀抭揄{同“抌”}冘抌揂																							
luʔ	luq	牖誘莠秀羑褎																							
luh	luh	狖																							
l̥uʔ	lhuq	首																							
l̥uh	lhuh	琇繡{錦~}																							
slu	slu	囚鮂苬																							
sluʔ	sluq	袖																							
sluh	sluh	牰岫																							
ru	ru	留鶹劉飂流旒裗瘤霤騮駵㧕榴瀏勠𤠑																							
ruʔ	ruq	柳罶懰䶉																							
ruh	ruh	窌塯溜廇餾																							
ɫu	ju	斿遊游蝣猷猶蕕卣輶楢庮																							
ɫuʔ	juq	酉輶槱																							
ɫ̥uʔ	jhuq	醜																							
hɫuʔ	hjuq	朽㱙																							
ku	ku	鳩救{及物？}																							
kuʔ	kuq	九韭究赳																							
kuh	kuh	救{不及物？}廄廐																							
kʰu	khu	蓲																							
gu	gu	求𧒔梂逑絿球銶賕捄{長而曲}脙仇朹犰䊵艽鼽頄厹																							
guʔ	guq	舅咎麔																							
guh	guh	鯦																							
hu	hu	休烋鵂髤髹庥貅咻																							
huh	huh	嗅																							
ʔu	qu	憂優懮瀀耰鄾櫌嚘麀纋																							
tru	tru	譸幬籌輈侜																							
truʔ	truq	肘疛																							
dru	dru	𠷎躊疇裯																							
druʔ	druq	紂																							
druh	druh	酎																							
nruʔ	nruq	紐杻狃禸𠘯莥																							
nruh	nruh	糅																							
n̥ruʔ	nhruq	丑																							
tsʰruh	tshruh	簉憱																							
sru	sru	搜溲蒐鄋獀䤹																							
sruʔ	sruq	叟瞍傁廋廀醙																							
sruh	sruh	瘦																							
lru	lru	紬																							
lruh	lruh	冑胄宙伷																							
l̥ru	lhru	抽妯怞																							
r̥u	rhu	㨨																							
kruʔ	kruq	氿軌匭簋厬宄孂																							
gru	gru	逵馗頯觓觩																							
pˤu	p'u	褒襃煲裒𨚔																							
pˤuʔ	p'uq	寶保葆堡褓䳈鴇駂																							
pˤuh	p'uh	報																							
bˤuʔ	b'uq	抱																							
mˤu	m'u	髦矛																							
mˤuh	m'uh	冒媢帽𪃑																							
tˤuʔ	t'uq	禂擣搗島																							
tʰˤuʔ	th'uq	禱討																							
dˤu	d'u	濤燾檮錭翢																							
dˤuʔ	d'uq	翿{舞具，形似雉扇}																							
dˤuh	d'uh	纛																							
nˤu	n'u	猱夒獿獶峱																							
nˤuʔ	n'uq	擾腦匘惱																							
n̥ˤu	nh'u	薅																							
n̥ˤuʔ	nh'uq	好																							
tsˤu	ts'u	遭糟傮㷮																							
tsˤuʔ	ts'uq	早棗蚤																							
tsˤuh	ts'uh	竈灶																							
tsʰˤuʔ	tsh'uq	草艸慅																							
tsʰˤuh	tsh'uh	慥																							
dzˤu	dz'u	曹𣍘漕螬																							
dzˤuʔ	dz'uq	造皁皂																							
sˤu	s'u	搔騷鰠溞																							
sˤuʔ	s'uq	埽掃嫂𦺋																							
sˤuh	s'uh	瘙																							
lˤu	l'u	綯陶{~器；和樂；鬱~；皐~}蜪騊䛬																							
lˤuʔ	l'uq	道稻蹈																							
lˤuh	l'uh	導陶{~~，驅馳貌}																							
l̥ˤu	lh'u	滔{水瀰漫}慆搯謟韜槄絛																							
rˤu	r'u	牢																							
rˤuʔ	r'uq	簝																							
rˤuh	r'uh	嫪																							
C.rˤu	C.r'u	醪																							
C.rˤuʔ	C.r'uq	老																							
kʰɫˤuʔ	khj'uq	考攷栲																							
kˤu	k'u	羔皋臯皐槔櫜䓘鼛韟䔌																							
kˤuh	k'uh	告{上~、祭~}誥郜禚																							
kʰˤu	kh'u	𦙷																							
kʰˤuʔ	kh'uq	尻																							
gˤu	g'u	嗥獋																							
gˤuʔ	g'uq	浩晧皓昊惢𠕫皞顥																							
gˤuh	g'uh	𧬁																							
ŋˤu	ng'u	翱																							
ʔˤu	q'u	鏖																							
ʔˤuʔ	q'uq	媼																							
ʔˤuh	q'uh	奧懊																							
pˤru	p'ru	包胞枹																							
pˤruʔ	p'ruq	飽苞																							
pʰˤru	ph'ru	拋脬																							
bˤru	b'ru	袍庖炮泡炰狍匏㯡																							
bˤruʔ	b'ruq	鮑																							
bˤruh	b'ruh	皰																							
mˤru	m'ru	茅罞																							
mˤruʔ	m'ruq	卯茆昴																							
tˤru	t'ru	鵃																							
tsˤruʔ	ts'ruq	爪																							
kˤruʔ	k'ruq	攪																							
kˤruh	k'ruh	窖窌窯																							
kʰˤruʔ	kh'ruq	巧																							
gˤru	g'ru	淆																							
gˤruh	g'ruh	斅																							
hˤru	h'ru	虓烋																							
hˤruh	h'ruh	孝																							
puk	puk	腹																							
pʰuŋ	phung	豐酆灃麷																							
pʰuŋh	phungh	賵																							
pʰuk	phuk	覆蝮																							
buŋ	bung	麷																							
buk	buk	蕧輹復{恢~；招魂}																							
muk	muk	目																							
tuŋ	tung	眾衆終螽蔠鼨																							
tuk	tuk	粥{半流質食物；~~，柔弱無能}鬻{同“粥”}祝𥙐鑄																							
stuk	stuk	叔菽																							
tʰuŋ	thung	充珫																							
tʰuk	thuk	俶柷																							
duk	duk	孰熟塾																							
nuŋ	nung	戎駥																							
nuk	nuk	肉																							
snuŋ	snung	娀																							
tsuk	tsuk	蹙䠞踧{~踖，恭敬而不安}蹴																							
tsʰuk	tshuk	戚{憂愁；親密}鼂																							
suŋ	sung	嵩崧																							
suk	suk	宿夙																							
luŋ	lung	融肜																							
luk	luk	儥鬻{同“儥”}																							
ruŋ	rung	隆癃																							
ruk	ruk	穋鵱稑鯥𩣱																							
C.ruk	C.ruk	六陸																							
ɫuk	juk	毓育淯粥{半流質食物}																							
hɫuk	hjuk	畜{養育}慉蓄{收藏，名詞}																							
kuŋ	kung	宮躳躬																							
kuk	kuk	𦥑匊菊掬鞠踘椈鞫蘜𥷚鵴																							
kʰuk	khuk	麴																							
guŋ	gung	窮藭																							
ʔuk	quk	薁蒮燠{~休，痛聲}隩澳																							
mruk	mruk	睦																							
truŋ	trung	中忠衷																							
truk	truk	竹筑築																							
tʰruŋ	thrung	忡																							
tʰruk	thruk	蓄{積聚、~養，動詞}滀畜{牲~；容納；制止}鄐稸																							
druŋ	drung	沖盅																							
druŋh	drungh	仲																							
nruk	nruk	衄忸																							
dzruŋ	dzrung	崇																							
sruk	sruk	縮謖蹜莤																							
lruŋ	lrung	蟲																							
lruk	lruk	軸																							
bˤuk	b'uk	轐																							
mˤuk	m'uk	瑁																							
tˤuŋ	t'ung	冬																							
tˤuk	t'uk	篤竺督裻																							
tʰˤuŋh	th'ungh	統																							
dˤuk	d'uk	毒𦺇																							
nˤuŋ	n'ung	農噥																							
tsˤuŋ	ts'ung	宗																							
tsˤuŋh	ts'ungh	綜																							
tsˤuk	ts'uk	傶																							
dzˤuŋ	dz'ung	潨潀淙琮賨																							
sˤuŋh	s'ungh	宋																							
lˤuŋ	l'ung	彤𢥞爞䳋赨																							
kˤuk	k'uk	告{~訴}梏牿䅵																							
kʰˤuk	kh'uk	酷俈嚳																							
gˤuk	g'uk	鵠																							
pʰˤruk	ph'ruk	鞄																							
bˤruk	b'ruk	雹䮀																							
mˤruk	m'ruk	瞀																							
kˤruŋh	k'rungh	降絳袶																							
kˤruk	k'ruk	覺																							
kʰˤruk	kh'ruk	礐																							
gˤruŋ	g'rung	降																							
gˤruk	g'ruk	學澩觷																							
ʔˤruk	q'ruk	鷽																							
pus	pus	芾{小；蔽~，小而茂密}																							
pʰus	phus	費																							
tuj	tuj	隹萑鵻騅錐																							
stujʔ	stujq	水																							
duj	duj	誰脽																							
nuj	nuj	蕤綏{旗}緌桵																							
snuj	snuj	綏夊																							
tsus	tsus	醉檇																							
tsʰujʔ	tshujq	趡																							
tsʰus	tshus	翠																							
dzus	dzus	萃瘁悴顇																							
sus	sus	粹誶賥睟																							
luj	luj	遺壝𧔥																							
lujʔ	lujq	遺{~~，隨行}唯{~~，隨行}																							
l̥us	lhus	邃祟																							
slus	slus	遂檖穟隧燧鐩禭襚璲繸旞																							
ruj	ruj	纍虆儽傫藟縲鸓㶟																							
rujʔ	rujq	壘櫐耒誄																							
C.rus	C.rus	類禷																							
kujʔ	kujq	鬼																							
kus	kus	瞶貴																							
kʰuj	khuj	蘬																							
ŋuj	nguj	巍犩																							
ŋujh	ngujh	魏																							
ʔuj	quj	威蝛畏隈																							
ʔujʔ	qujq	磈																							
ʔus	qus	慰蔚犚熨螱褽罻																							
truj	truj	追																							
trus	trus	轛																							
druj	druj	椎顀																							
sruj	sruj	衰{~微，~老，~弱}榱涒																							
lrus	lrus	墜																							
srus	srus	率{~領；表~；勸誡；一般}帥																							
krujh	krujh	愧媿騩																							
gruj	gruj	夔																							
grus	grus	饋餽櫃樻匱簣鞼																							
bˤus	b'us	孛悖𢨋旆{~~，茂盛}																							
mˤus	m'us	昧																							
tˤuj	t'uj	堆敦{治理；雕刻；投擲；~彼}																							
tʰˤuj	th'uj	推蓷																							
dˤuj	d'uj	魋																							
dˤujh	d'ujh	憝譈																							
nˤujʔ	n'ujq	餧餒																							
tsˤujh	ts'ujh	捘																							
tsˤus	ts'us	晬																							
tsʰˤuj	tsh'uj	崔縗																							
tsʰˤujʔ	tsh'ujq	漼																							
tsʰˤus	tsh'us	倅淬啐焠																							
dzˤuj	dz'uj	摧																							
dzˤujʔ	dz'ujq	罪辠																							
sˤus	s'us	碎																							
lˤuj	l'uj	穨頹頽蘈㿉僓隤																							
lˤus	l'us	隊																							
l̥ˤuj	lh'uj	藬																							
rˤuj	r'uj	雷靁畾櫑罍𤴇𡔁																							
rˤujʔ	r'ujq	磊礨磥																							
rˤujh	r'ujh	䣂																							
rˤus	r'us	蘱纇																							
kˤuj	k'uj	𧢦櫰傀																							
kˤus	k'us	憒																							
kʰˤuj	kh'uj	魁𩳁																							
kʰˤujh	kh'ujh	塊																							
kʰˤus	kh'us	蕢																							
gˤujʔ	g'ujq	廆瘣藱																							
gˤujh	g'ujh	螝																							
gˤus	g'us	繢闠潰䜋																							
ŋˤuj	ng'uj	嵬																							
ŋˤujʔ	ng'ujq	隗																							
ʔˤuj	q'uj	煨偎椳㙗																							
ʔˤujʔ	q'ujq	猥																							
kʰˤrus	kh'rus	蒯㕟𦳋嘳																							
gˤruj	g'ruj	槐懷瀤褢壞																							
gˤrujh	g'rujh	蘾																							
ŋˤrus	ng'rus	聵																							
ʔˤruj	q'ruj	崴																							
pun	pun	饙餴																							
punh	punh	糞																							
put	put	弗黻韍巿																							
pʰun	phun	芬紛{盛多；繽~}																							
pʰut	phut	祓																							
bun	bun	賁焚蚡																							
but	but	岪																							
mun	mun	聞																							
munh	munh	問																							
mut	mut	物勿																							
tun	tun	肫{~~，誠懇}諄																							
tunʔ	tunq	準綧埻																							
tunh	tunh	訰																							
tut	tut	拙																							
stunh	stunh	鬊																							
tʰun	thun	春萅																							
tʰunʔ	thunq	蠢惷舛																							
tʰut	thut	出																							
dun	dun	純肫鶉醇淳錞{~于}漘																							
nun	nun	犉																							
nunh	nunh	閏潤																							
tsun	tsun	遵僎鷷																							
tsunh	tsunh	畯俊焌駿餕晙𤮪																							
tsʰun	tshun	壿逡竣踆																							
dzut	dzut	崒																							
sunʔ	sunq	簨栒																							
sunh	sunh	浚峻晙陖鵔																							
lunʔ	lunq	楯允狁馻																							
slun	slun	循																							
mlunʔ	mlunq	揗吮																							
l̥unh	lhunh	舜																							
mlut	mlut	术術述秫鉥沭																							
run	run	侖倫淪論崙鯩棆惀																							
rut	rut	律率{法令；佩巾；句首助詞}𦆽膟																							
C.run	C.run	輪																							
ɫunʔ	junq	尹																							
ɫut	jut	聿芛																							
ɫ̥un	jhun	川																							
ɫ̥unh	jhunh	釧																							
mɫunh	mjunh	順																							
mɫun	mjun	紃巡馴																							
hɫunh	hjunh	訓																							
kun	kun	君																							
kunh	kunh	攟																							
kut	kut	屈{地名}鶌																							
kʰut	khut	屈詘𧌑																							
gun	gun	帬裙羣群𤸷																							
gunh	gunh	郡																							
gut	gut	倔屈{短}																							
ŋunʔ	ngunq	齫																							
ʔun	qun	藴緼																							
ʔunh	qunh	愠慍醞																							
ʔut	qut	鬱𩏴尉																							
prut	prut	筆																							
brut	brut	弼																							
mrun	mrun	緡緍																							
trun	trun	窀																							
trut	trut	絀窋泏																							
tʰrun	thrun	椿杶櫄																							
tʰrunʔ	thrunq	蜳																							
tʰrut	thrut	黜茁欪																							
srut	srut	蟀率{順著；自、從}																							
lrut	lrut	朮𦬸怷																							
l̥run	lhrun	鶞輴楯{同“輴”}																							
l̥rut	lhrut	怵怴䟣㾁																							
r̥un	rhun	䡅																							
krun	krun	麇麕𢋵																							
kʰrun	khrun	囷蜠																							
grunʔ	grunq	莙菌窘箘蜠𡹤																							
ʔrun	qrun	頵																							
pˤun	p'un	奔犇																							
pˤunʔ	p'unq	畚本																							
bˤut	b'ut	誖																							
mˤun	m'un	璊																							
mˤut	m'ut	沒歾歿𤤄																							
m̥ˤun	mh'un	婚昏昬𩌲惽涽惛殙																							
m̥ˤut	mh'ut	惚{恍~}																							
tˤun	t'un	敦錞{鐏}惇橔																							
tˤunh	t'unh	頓敦{豎立；食器；困~}																							
tˤut	t'ut	咄																							
tʰˤun	th'un	啍{~~，車行聲}暾焞{明亮；~~，車行聲}𪏆䵍																							
dˤun	d'un	屯沌{~~，無知；圓轉貌}韕芚忳鈍㹠軘庉{火熾盛貌}																							
dˤunʔ	d'unq	庉沌{渾~}																							
dˤunh	d'unh	鐓																							
nˤut	n'ut	訥																							
tsˤun	ts'un	尊樽繜朘																							
tsˤunʔ	ts'unq	撙噂僔																							
tsˤut	ts'ut	卒																							
tsʰˤunʔ	tsh'unq	忖刌																							
tsʰˤunh	tsh'unh	寸																							
tsʰˤut	tsh'ut	猝																							
dzˤun	dz'un	蹲																							
dzˤunʔ	dz'unq	鱒																							
dzˤunh	dz'unh	鐏																							
dzˤut	dz'ut	捽																							
sˤun	s'un	孫蓀飧飱蕵																							
sˤunh	s'unh	遜																							
sˤut	s'ut	窣																							
lˤun	l'un	豚遯遁																							
lˤunʔ	l'unq	盾腞																							
lˤut	l'ut	腯突葖鼵鶟																							
rˤun	r'un	菕掄崘																							
rˤunh	r'unh	論																							
kɫˤunʔ	kj'unq	袞衮蔉																							
kˤun	k'un	昆崑崐䖵晜鯤鵾琨騉菎																							
kˤunʔ	k'unq	緄䃂鯀鮌																							
kˤunh	k'unh	睔																							
kˤut	k'ut	淈																							
kʰˤun	kh'un	髠髡坤巛																							
kʰˤunʔ	kh'unq	壼捆稛閫梱綑齫悃																							
kʰˤunh	kh'unh	困																							
kʰˤut	kh'ut	堀窟																							
gˤun	g'un	繉餫																							
gˤunʔ	g'unq	混䧰																							
gˤunh	g'unh	圂溷慁焜																							
ŋˤun	ng'un	梱{木名}																							
ŋˤut	ng'ut	兀扤卼{臲~，動搖不安}杌{~隉，動搖不安}阢																							
ʔˤun	q'un	溫縕轀豱韞																							
tˤrut	t'rut	𠿡																							
nˤrut	n'rut	貀																							
kˤrun	k'run	綸																							
stumʔ	stumq	沈{諸侯}邥																							
dum	dum	諶忱																							
dumʔ	dumq	甚																							
num	num	荏{大豆}																							
nəps	nyps	芮汭枘																							
l̥um	lhum	深冞䍘																							
ləps	lyps	肄{習}																							
sləps	slyps	肆																							
rəps	ryps	淚涖莅																							
C.rum	C.rum	臨																							
kum	kum	今																							
kumʔ	kumq	錦																							
gum	gum	禽擒																							
ʔum	qum	陰霠瘖																							
ʔumʔ	qumq	飲																							
ʔumh	qumh	蔭廕																							
trəps	tryps	懟																							
drum	drum	沈																							
tsʰrum	tshrum	參																							
srumh	srumh	滲																							
krəps	kryps	洎{添水於鍋中；湯汁}																							
grəps	gryps	洎{浸潤；到}																							
wrəps	wryps	位																							
tˤum	t'um	耽																							
tˤəps	t'yps	對荅																							
dˤəps	d'yps	㬣																							
nˤəps	n'yps	内內																							
n̥ˤəps	nh'yps	退																							
tsˤumʔ	ts'umq	簪{快}																							
tsʰˤum	tsh'um	驂																							
tsʰˤumʔ	tsh'umq	憯{快}																							
sˤum	s'um	三犙																							
lˤəps	l'yps	逮棣																							
kˤumh	k'umh	紺																							
kʰˤumʔ	kh'umq	貪																							
ʔˤumʔ	q'umq	黤黭黯黬晻隌堷																							
ʔˤumh	q'umh	闇暗																							
dˤrum	d'rum	湛{（水）深、積水；河名}																							
