参考资料		《现代汉语方言音库·昆明话音档》、复旦中华文明数据中心、中国语言资源保护工程采录展示平台
方言点		云南省昆明市五华区老城内
方言归属		西南官话-云南片-滇中小片
说明		音系排列，先以韵母为序，在同韵的字里按声母的顺序排列，声母相同的按声调排列。
调值		①阴平44②阳平42③上声53④去声212
IPa		
宽式	严式	
		ɿ
tsɿ	tsɿ	①资姿咨枝肢兹滋辎孜③紫姊子梓滓④自字
tsʰɿ	tsʰɿ	①疵差（参～）②词慈辞糍③此④次茨刺赐翅
sɿ	sɿ	①斯撕厮嘶私司丝思师狮③死④似祀巳（辰～）寺嗣饲伺柿俟事士仕
		ʅ
tʂʅ	tʂʅ	①之芝知支②置执挚汁姪质直值殖植织职掷炙③纸只（～有）旨指脂止趾址④稚智致至窒痔峙治志痣
tʂʰʅ	tʂʰʅ	①痴嗤②吃迟持赤斥尺池驰③齿侈（奢～）匙耻④斥叱
ʂʅ	ʂʅ	①尸诗豉（豆～）施②饬食蚀识适释石时鲥湿十什（～物）拾实失室③矢豕屎史驶使始④示视嗜市试式饰是氏侍适（合～）
ʐʅ	ʐʅ	②日肏
		i
pi	pi	①屄②鼻笔毕必弼逼碧壁③彼比④闭箅（～子）弊币毙陛避
pʰi	pʰi	①披批匹（布～）②皮疲琵匹僻辟霹脾③痹（麻～）鄙庇匹（～夫）④屁
mi	mi	①咪眯②泌蜜密弥觅迷靡糜谜③米④谜（文）
ti	ti	①低②的（目～）滴笛敌狄籴③底抵④帝弟第递隶
tʰi	tʰi	①梯剔②题提堤啼蹄踢涕嚏③体④替屉
ni	ni	②倪尼泥呢溺匿暱逆③礼你女④腻
li	li	②黎犁梨篱璃力厘历栗驴律率（效～）③里理鲤李旅④丽离例厉励荔利莉痢吏虑滤
tɕi	tɕi	①鸡稽几（～乎）机饥肌基姬羁居车（～马炮）拘驹疽②缉辑集及级汲吸给（供～）疾吉即戟屐积籍鲫稷棘极绩寂击激橘局侷菊③挤几（～何己纪）举矩④祭际济荠计继系（～鞋带）季技妓寄记忌既冀据锯巨钜拒距遽聚具俱句惧矩剧
tɕʰi	tɕʰi	①妻凄悽溪欺期骑蛆区驱趋②齐脐蛴奇岐祁耆鳍其棋旗祈七漆膝乞迄吃戚渠瞿屈③启岂起杞取娶④砌契企器弃气汽去（文）趣
ɕi	ɕi	①西栖犀兮奚牺嘻嬉禧熙希稀虚嘘墟樨须鬚需荽②习袭悉息熄媳隙昔惜席夕锡析婿膝徐蓄恤③洗喜蟢（～子）屣许④细系係戏序叙绪絮
i	Øi	①衣依医伊淤迂②宜谊仪蚁移易夷姨胰懿疑怡贻一乙逸抑弋益亦译缢郁鱼渔于吁盂於余馀愚虞娱郁域狱裕浴③椅以拟已矣尾（又）迤语与雨宇禹羽屿④意异肄翼毅亿忆艺呓诣瞖义议熠宜（便～）御誉预豫遇寓芋俞榆愉渝愈喻玉
		u
pu	pu	③哺捕补④不布佈怖步埠（商～）部簿阜（又）
pʰu	pʰu	①铺（～设）②仆朴扑蒲脯菩勃卜瀑曝讣③普谱甫④铺（店～）
mu	mu	②模（～子）目穆牧木沐③母拇④墓（又）
fu	fu	①夫肤敷俘（～虏）②扶符复弗拂彿佛③府俯腑腐辅斧抚釜④付赋附傅赴父富副妇负阜埠
tu	tu	①都②笃督毒独读牍③堵赌肚（～子）④妬蠹杜肚（腹～）度踱渡镀
tʰu	tʰu	①□（温～）②徒屠途图突秃③土吐（～痰）④吐（呕～）兔
nu	nu	②奴③努④怒
lu	lu	①噜（香～～）②卢芦炉庐（茅～）鹿禄绿③鲁橹滷虏④路赂露
ku	ku	①姑辜孤②骨谷③古估（～计）盬（～子）贾（商～）股鼓④故固雇顾
kʰu	kʰu	①枯箍②哭瓠（～芦）窟酷③苦④库裤
xu	xu	①呼乎②胡蝴湖狐壶忽③虎浒（水～）④户沪互护
tsu	tsu	①租②卒足築③祖组诅④助
tsʰu	tsʰu	①粗初②锄猝族雏蹴③楚础④醋
su	su	①苏酥梳疏蔬②续速③数（动词）④素诉嗉数（名词）
tʂu	tʂu	①诸猪朱株珠铢茱②竹竺筑烛逐祝粥触③煮主嘱④柱驻注住铸著苧（～麻）箸（筷子）
tʂʰu	tʂʰu	①□（～出来）②除出厨③储褚（姓）杵暑薯鼠处（～理）④处（住～）
ʂu	ʂu	①书舒枢输殊②术述秫黍赎熟③曙④墅署豎戍数（名词）庶恕漱
ʐu	ʐu	①擩（～进去）②如入肉（白）③汝乳儒④辱（悔～）
u	Øu	①乌坞钨污巫诬②吾梧吴蜈无毋勿物屋③五伍午舞武鹉侮④误悟恶（可～）务雾
		ᴀ
pa	pᴀ	①巴芭疤②爸八拔③把（～柄，一～）④霸坝把（柄）罢
pʰa	pʰᴀ	①𤆵②爬琶杷④怕帕
ma	mᴀ	①妈②麻痳蟆（蛤～）③马码④骂
fa	fᴀ	②法乏发伐阀筏罚
ta	tᴀ	①瘩②答搭达靼③打④大（～小）
tʰa	tʰᴀ	①他它耷②踏塔榻塌坍（～下来）獭（水～）遢
na	nᴀ	②拿纳衲捺③喇哪④那
la	lᴀ	①拉邋②辣腊蜡镴𤷫③喇
ka	kᴀ	③嘎尬
kʰa	kʰᴀ	①咖卡（～在里面）③卡（～车）
xa	xᴀ	①哈④下（等一～）
tsa	tsᴀ	②杂砸咂咋
tsʰa	tsʰᴀ	②擦
sa	sᴀ	②卅萨飒靸③洒撒
tʂa	tʂᴀ	①楂渣乍②闸炸（油～）铡眨扎札（～刀）轧劄（～记）③柞④诈榨（～油）炸（～弹）
tʂʰa	tʂʰᴀ	①叉杈（枝～）差（～别）②茶搽查（调～）插察擦③衩（又）④诧岔汊（水歧流）衩
ʂa	ʂᴀ	①沙纱②霎杀煞刹③傻
a	Øᴀ	①阿啊④二贰
		iᴀ
nia	niᴀ	①□（～声～气）
lia	liᴀ	②□（～脱）
tɕia	tɕiᴀ	①家傢稼加嘉佳②夹甲匣胛狎③假贾（姓）④架驾价嫁稼（又）
tɕʰia	tɕʰiᴀ	①掐（一～）②恰（文）洽掐（文）③卡（发～）④□（～进去）
ɕia	ɕiᴀ	①虾②霞瑕遐暇峡狭侠硖挟（～制）辖瞎裌 ④下（～面）
ia	Øiᴀ	①鸦丫（～头）桠（～杈）②牙芽迓衙涯鸭押压③雅讶哑④亚轧（被车～）
		uᴀ
tʂua	tʂuᴀ	①抓②斫挝③爪（～子）
tʂʰua	tʂʰuᴀ	③□（～嘚）
ʂua	ʂuᴀ	②刷③耍
ʐua	ʐuᴀ	②挼
kua	kuᴀ	①瓜呱②括刮③寡剐④卦挂
kʰua	kʰuᴀ	①夸③垮④跨
xua	xuᴀ	①花②华（中～，～山）划（～船）④化画话划（计～）
ua	Øuᴀ	①蛙挖（城）②娃挖（乡）袜③瓦④洼凹
		o
po	po	①波玻播②博钵拨脖薄缚剥驳③跛簸（～一～）④播（又）簸（～箕）
pʰo	pʰo	①坡②婆泼泊③颇剖④破
mo	mo	①摩摸么②摩（又）磨（～刀）魔莫膜寞模（～范）末沫③抹（～药）④磨（～面）慕暮募墓幕
to	to	①多②夺度（揣～）③朵④惰堕舵驮（～子）掇（拾～）
tʰo	tʰo	①拖②驮陀驼（～背）脱托讬铎③妥④唾（～沫，～液）
no	no	①喏（睡～～）②诺挪④糯（～米）
lo	lo	②罗锣箩啰（～嗦）骡螺（～蛳）脶（手指纹）洛落骆烙络酪乐（快～）③倮裸④摞（～起来）
ko	ko	①哥歌戈锅②角（白）割葛各阁搁郭国鸽③果裹④过
kʰo	kʰo	①轲苛科棵窠颗②壳磕（～头）阔廓扩渴③可④课
xo	xo	①豁喝呵（～欠）②活和（～气）河何荷（～花）盍合盒壑鹤霍藿或惑③火伙夥④贺货祸和（～泥）
tso	tso	②作昨③左佐④坐座
tsʰo	tsʰo	①搓②撮③□（～娃娃）④锉矬错措
so	so	①娑（婆～）蓑梭唆②缩索③锁琐所
tʂo	tʂo	②着凿酌绰卓桌琢啄浊捉镯
tʂʰo	tʂʰo	②绰戳
ʂo	ʂo	②朔勺硕说
ʐo	ʐo	②弱若
o	Øo	①倭窝蜗②蛾鹅俄讹鄂鳄恶握③我④卧饿
		ə
pə	pə	①□（～嘚）②北百柏伯白帛
pʰə	pʰə	②迫拍珀魄
mə	mə	①么②陌默墨麦脉
tə	tə	①嘚（听～)②得德④嘚（跑～）
tʰə	tʰə	①他（白）②特忒
nə	nə	①呢③那④那
lə	lə	②肋勒③了
kə	kə	②格革隔嗝胳③□（～是）给（白）④个锯（～嘚）
kʰə	kʰə	②客咳刻克磕（～膝头）④去（～哪点）
xə	xə	②纥曷黑赫吓（白）核
tsə	tsə	②则窄摘责仄
tsʰə	tsʰə	②泽择策册
sə	sə	②涩瑟虱塞
tʂə	tʂə	①遮②折浙摺③者
tʂʰə	tʂʰə	①车②彻撤宅拆辄③扯④䞣
ʂə	ʂə	①奢赊②摄涉舌设折（弄～了）③捨④射舍（宿～）
ʐə	ʐə	②热③惹
		ɚ
ɚ	Øɚ	②儿而轭③尔耳饵洱珥佴迩
		ie
pie	pie	①憋②别鳖③瘪
pʰie	pʰie	②撇（撇捺）③撇（撇棍子）④□（太～了）
mie	mie	②灭蔑
tie	tie	①爹②叠牒蝶谍迭跌
tʰie	tʰie	②贴铁
nie	nie	②聂镊孽捏业④蹑
lie	lie	①猎列烈裂劣
tɕie	tɕie	①家（你～）嗟（～来之食）②接捷劫杰孑节截结诘洁揭竭绝厥孓（孑～）掘倔崛蹶撅（～子）决诀③姐④借藉
tɕʰie	tɕʰie	②怯切缺阙（宫～）茄瘸③且④妾
ɕie	ɕie	①些靴②邪斜脅协歇蝎血薛屑雪血穴③写④泻卸谢泄亵
ie	Øie	①耶椰②爷谒噎阅悦月曰越粤樾钺③也野冶④夜
		iu
tɕiu	tɕiu	②掬鞠
tɕʰiu	tɕʰiu	②曲屈掘
ɕiu	ɕiu	②畜蓄戌
iu	Øiu	②育欲浴域郁狱
		æ
pæ	pæ	①□（脚～了）③摆④拜败稗
pʰæ	pʰæ	②排（文）牌③排（白）④派
mæ	mæ	②埋③买④卖迈
tæ	tæ	①呆（文）③歹逮④戴带待怠殆代袋贷大（～夫）
tʰæ	tʰæ	①胎②台苔抬④态太泰
næ	næ	①奶③乃奶（牛～）④耐奈
læ	læ	②来③□（～在上面）④赖癞
kæ	kæ	①揩偕稭（麦～）该阶皆街③改解（讲～）④盖丐概介芥疥界尬届戒械
kʰæ	kʰæ	①开揩③凯恺楷④溉慨
xæ	xæ	①嗨□（～大的）②孩偕谐鞋还（～有）③海蟹④亥骇解（姓）懈害
tsæ	tsæ	①灾栽③宰④载再在
tsʰæ	tsʰæ	①猜②才财材裁③彩採睬④菜蔡
sæ	sæ	①腮④赛
tʂæ	tʂæ	①斋④债寨
tʂʰæ	tʂʰæ	①差（出～）钗②柴豺③踩
ʂæ	ʂæ	①筛（～子）④晒
æ	Øæ	①哀唉②埃挨崖岩呆（白）③矮④碍艾爱霭蔼隘
		uæ
tʂuæ	tʂuæ	③跩（大～～）
tʂʰuæ	tʂʰuæ	①揣（～在口袋）③揣（～摩）④踹
ʂuæ	ʂuæ	①衰摔③甩④帅率（统～）
kuæ	kuæ	①乖③拐④怪
kʰuæ	kʰuæ	③块蒯④会（～计）刽快筷
xuæ	xuæ	②怀槐淮④坏
uæ	Øuæ	①歪③崴④外
		əe
pei	pəe	①杯背卑碑禆俾婢悲篦（～麻子）④贝敝蔽辈背倍臂被备
pʰei	pʰəe	①胚（～胎）坯（土～）披批②培陪赔裴③呸④沛配佩譬辔
mei	məe	②梅枚玫媒煤眉楣媚没（～有）③每美④妹昧谜（白）寐没（～有，又）
fei	fəe	①非飞妃菲②肥③匪④废肺吠痱（～子）沸费
tsei	tsəe	②贼
ei	Øəe	②欸③欸
		uəe
tuei	tuəe	①堆④对队碓兑
tʰuei	tʰuəe	①推②颓③腿④退
nuei	nuəe	③馁④内
luei	luəe	②雷③儡馁累（～积）垒④累（劳～）类泪
kuei	kuəe	①圭闺规龟归③诡轨晷鬼④瑰鳜桂跪癸柜贵
kʰuei	kʰuəe	①盔亏窥②魁奎逵夔葵揆③傀④溃愧
xuei	xuəe	①灰诙恢麾挥辉徽②回③悔毁④会（开～）绘晦汇慧彗惠秽讳卉荟贿
tsuei	tsuəe	③嘴④最罪（点～）醉
tsʰuei	tsʰuəe	①崔催④脆翠悴粹
suei	suəe	①虽（文）尿（白）②随髓④碎岁遂隧穗
tʂuei	tʂuəe	①追锥④赘坠缀
tʂʰuei	tʂʰuəe	①吹炊②槌垂锤
ʂuei	ʂuəe	②谁③水④税睡
ʐuei	ʐuəe	③蕊④锐睿瑞
uei	Øuəe	①煨巍威②危桅为（作～）帷维惟唯围违微薇③委餧伟苇纬尾④卫为（～哪样）伪位遗魏未味胃蝟谓畏慰
		əɔ
pau	pəɔ	①包胞③保褒堡宝饱④报抱铇雹暴爆豹
pʰau	pʰəɔ	①抛泡②袍刨③跑④炮泡（又）
mau	məɔ	①猫②毛矛茅锚谋③卯亩（白）某（白）牡④冒帽貌
tau	təɔ	①刀叨（唠～）③祷岛倒（打～）④到倒（～水）道稻盗导
tʰau	tʰəɔ	①滔掏涛②桃逃陶萄淘③讨④套
nau	nəɔ	②挠铙③脑④闹
lau	ləɔ	①捞（～出来）②劳捞（打～）唠牢③老④涝
kau	kəɔ	①高膏羔糕铰（白）③稿搞搅（白）④告窖（白）
kʰau	kʰəɔ	①敲③考烤④靠犒
xau	xəɔ	①蒿薅②豪毫号（呼～）③好（～坏）④浩好（喜～）耗号（～数）
tsau	tsəɔ	①遭糟召③早枣蚤澡④躁灶皂造
tsʰau	tsʰəɔ	①操②曹巢③草騲炒吵④造噪燥譟
sau	səɔ	①骚臊③扫（～地）嫂④扫（～帚）
tʂau	tʂəɔ	①召招昭朝（～阳）②着（～了）③找爪（～牙，～子）④罩照
tʂʰau	tʂʰəɔ	①抄钞②朝（～着）潮③吵炒④耖
ʂau	ʂəɔ	①梢捎稍②韶苕③少（多～）④少（～年）邵绍潲（～水）
ʐau	ʐəɔ	②饶挠（又）③扰绕（围～）④绕（～圈）
au	Øəɔ	①爊（～白菜）②熬③袄④傲奥懊拗（脾气～）
		iəɔ
piau	piəɔ	①膘（肥～）标彪③表錶
pʰiau	pʰiəɔ	①飘②瓢③漂（～白）④票漂（～亮）
miau	miəɔ	①喵瞄②苗描③藐渺秒④妙庙谬（文）
tiau	tiəɔ	①刁雕貂③屌④钓吊掉调（～动）
tʰiau	tʰiəɔ	①挑②条调（～和）③调（～头）④跳粜
niau	niəɔ	③鸟④尿
liau	liəɔ	①撩②燎療聊辽撩瞭③了（～结）④寥廖料
tɕiau	tɕiəɔ	①交郊铰（文）胶教（～书）焦椒骄娇浇②嚼（～筋）③绞狡搅剿矫缴④教（～育）校（～对）较窖觉（～觉）轿叫窍
tɕʰiau	tɕʰiəɔ	①锹跷悄②樵瞧乔桥荞憔③巧④鞘（刀～）诮
ɕiau	ɕiəɔ	①消霄宵硝销嚣萧箫骁②淆肴③小晓④孝酵肴餚淆校（学～）效笑
iau	Øiəɔ	①妖邀要（～求）腰幺夭②摇谣窑姚尧③咬舀（～水）杳④要（重～）耀
		əu
məu	məu	②牟眸谋③某冇④茂贸
fəu	fəu	②浮③否④埠
təu	təu	①兜③斗抖陡④斗（～争）豆逗荳
tʰəu	tʰəu	①偷②头投③□（～散）④透
nəu	nəu	④耨
ləu	ləu	②楼③搂篓④漏陋
kəu	kəu	①勾钩沟③狗苟④垢彀（往上～）够构购媾
kʰəu	kʰəu	①抠③口④叩（文，～头）扣寇蔻
xəu	xəu	①齁②侯喉猴③吼④后厚候
tsəu	tsəu	①邹③走④奏
tsʰəu	tsʰəu	①搊②愁④凑
səu	səu	①搜飕馊蒐②宿③叟④嗽（咳～）瘦
tʂəu	tʂəu	①周舟州洲③肘帚④昼纣宙皱绉骤咒
tʂʰəu	tʂʰəu	①抽②绸稠筹雠酬仇③丑瞅④臭（香～）
ʂəu	ʂəu	①收③手首守④兽受授售寿
ʐəu	ʐəu	②柔揉蹂④肉
əu	Øəu	①区（姓）欧讴殴③藕偶呕（～吐）④沤（久浸于水中）怄（～气）
		iəu
miəu	miəu	④谬
tiəu	tiəu	①丢
niəu	niəu	②牛③纽扭④拗（～紧）
liəu	liəu	①溜②流硫琉刘留榴③柳④瘤榴
tɕiəu	tɕiəu	①揪鸠阄（拈～）③酒九久韭灸④就救究舅臼咎旧柩
tɕʰiəu	tɕʰiəu	①秋丘②囚求球仇（姓）酋
ɕiəu	ɕiəu	①修羞休③朽④秀锈绣袖嗅（用鼻～）
iəu	Øiəu	①忧优悠幽②尤邮由油游犹③有友酉莠④诱又右祐柚釉幼黝
		ᴀ̃
pã	pᴀ̃	①班斑颁扳般搬邦帮浜（一条～）③板版绑榜谤④扮瓣办半伴绊棒蚌傍
pʰã	pʰᴀ̃	①攀潘肨（～臭）②盘磐胮庞旁傍③膀（整～皮）④盼袢（纽～）判叛胖
mã	mᴀ̃	①䊟䐽（～嘟嘟）②蛮瞒馒忙芒茫③满莽④曼慢漫幔
fã	fᴀ̃	①番藩翻方芳②凡帆梵烦繁樊妨肪房防③反仿纺彷访④范犯泛饭贩放
tã	tᴀ̃	①担（～任）丹单（～独）当③胆党掸（～尘）④担（～子）谈诞旦但惮弹（子～）蛋荡宕当（～掉）
tʰã	tʰᴀ̃	①贪滩摊汤膛②谭谈痰檀壇弹（～琴）堂螳唐糖塘坛昙③毯坦倘躺忐④探炭叹烫趟
nã	nᴀ̃	②南楠男难（～易）③攮④难（患～）
lã	lᴀ̃	②兰拦栏婪蓝篮囊郎螂廊狼朗③览揽榄缆懒琅漤④滥烂浪澜
kã	kᴀ̃	①甘柑泔（～水）尴（～尬）干肝竿（竹～）干（～湿）冈刚纲钢岗缸肛③感敢橄桿擀赶港④干（树～）杠
kʰã	kʰᴀ̃	①堪勘嵌（白）看（～守）刊康糠龛②扛③坎瞰侃槛④看抗炕瞰阚
xã	xᴀ̃	①酣鼾憨夯②含函涵邯寒韩行（～列）航杭③喊罕④撼旱焊捍汗汉项（白）巷
tsã	tsᴀ̃	①簪脏（肮～）赃臧③攒趱④赞葬脏（内～）藏（西～）
tsʰã	tsʰᴀ̃	①参餐汆仓苍伧②蚕惭残藏（～好）③惨④灿
sã	sᴀ̃	①三桑丧（婚～）③散（鞋带～了）嗓④散（～会）丧（～失）
tʂã	tʂᴀ̃	①张章樟漳沾粘占瞻氈②肠场长（～短）③盏展长（生～）④暂站佔蘸绽栈战颤溅（白)丈仗杖帐账胀障
tʂʰã	tʂʰᴀ̃	①搀昌猖②蝉禅缠谗馋常尝裳③产铲谄厂敞④忏倡（提～）唱怅畅
ʂã	ʂᴀ̃	①山珊删膻杉衫商伤③陕闪赏偿晌④讪疝扇搧善膳擅单（姓）禅（～让）赡上尚
ʐã	ʐᴀ̃	②然燃瓤③染冉壤攘嚷釀④让
ã	Øᴀ̃	①庵淹安鞍肮②昂④谙暗岸按案
		iɛ
piɛ	piɛ	①鞭边编③贬扁匾蝙④辩辨辫变汴便（方～）
pʰiɛ	pʰiɛ	①篇偏②便（～宜）骈④骗片
miɛ	miɛ	②绵棉眠③免勉娩缅④面麵
tiɛ	tiɛ	①滇颠巅掂③点典碘④佃甸店电殿奠佃垫
tʰiɛ	tʰiɛ	①添天②甜田填③忝舔
niɛ	niɛ	①拈②黏鲇年③碾辇撵撚④念
liɛ	liɛ	②廉镰连联怜莲帘③脸④练炼恋殓敛
tɕiɛ	tɕiɛ	①监尖兼间（文，房～）奸姦煎肩坚艰绢捐涓③检捡简柬拣谏剪茧涧捲（～起）④鉴舰渐剑间（～断）践件箭溅贱荐见圈（猪～）卷倦眷券
tɕʰiɛ	tɕʰiɛ	①歼（～灭）签佥纤谦迁笺千牵铅圈（圆～）②潜钳乾（～坤）虔嵌全痊泉权拳鬈③浅遣犬④欠歉劝
ɕiɛ	ɕiɛ	①暹嫌仙鲜先宣喧②衔咸鹹闲涎贤弦旋镟眩悬玄③显险癣选④陷馅限苋现线羡县楦
iɛ	Øiɛ	①淹（文）阉醃焉蔫研烟燕（～京）冤渊②盐炎阎严颜延筵俨檐芫员圆园元缘沿原源袁辕援垣③掩眼演兖远④验厌靥（酒～）艳砚焰酽雁晏谚宴燕（～子）嚥院愿怨
		uᴀ̃
tuã	tuᴀ̃	①端③短④断段锻缎
tʰuã	tʰuᴀ̃	①湍②团
nuã	nuᴀ̃	③暖
luã	luᴀ̃	②栾滦挛孪鸾③卵④乱
kuã	kuᴀ̃	①官关观（参～）冠（衣～）鳏光③管馆广④贯惯罐灌观（道～）冠（～军）逛
kʰuã	kʰuᴀ̃	①宽匡框②狂③款④旷矿况
xuã	xuᴀ̃	①欢荒慌②桓还（～原）环黄皇蝗③缓谎恍幌④唤换焕幻患宦
tsuã	tsuᴀ̃	①钻④钻
tsʰuã	tsʰuᴀ̃	①汆蹿④篡纂串窜
suã	suᴀ̃	①酸④算蒜
tʂuã	tʂuᴀ̃	①专砖庄桩装妆③转（～车）④转（～过去）状壮赚撰篆传（～记）撞
tʂʰuã	tʂʰuᴀ̃	①川钏穿疮窗②船传（～达）椽床③喘闯撞（又）④串创
ʂuã	ʂuᴀ̃	①闩栓霜孀双③爽④涮
ʐuã	ʐuᴀ̃	③软阮
uã	Øuᴀ̃	①弯湾豌汪②完丸纨玩顽王亡忘③皖宛碗腕惋婉晚挽往枉网④万望忘妄旺
		ə̃e
pə̃	pə̃e	①奔③本苯④笨
pʰə̃	pʰə̃e	①喷烹②盆彭朋④喷（香～～）
mə̃	mə̃e	①闷（～着）②门④闷（沉～）
fə̃	fə̃e	①分芬纷吩②坟焚汾③粉④愤粪奋忿份氛
tə̃	tə̃e	①登灯蹬③等④凳邓瞪
tʰə̃	tʰə̃e	①熥②腾誊藤疼③□（说话打～）④□（时间～的太长了）
nə̃	nə̃e	②能
lə̃	lə̃e	②楞（～角）③冷④楞（～住）睖
kə̃	kə̃e	①跟根更（～换）庚羮耕③亘哽粳耿④更（～加）亘
kʰə̃	kʰə̃e	①坑③恳垦肯
xə̃	xə̃e	①哼②痕恒衡③很④恨杏（白）
tsə̃	tsə̃e	①曾（姓）增赠僧争筝睁③怎④憎
tsʰə̃	tsʰə̃e	①撑参（～差）②曾（～经）层岑③碜④蹭衬
sə̃	sə̃e	①森僧生笙牲甥③省
tʂə̃	tʂə̃e	①针斟珍榛臻真贞③枕诊疹④镇阵振震正政症朕郑圳
tʂʰə̃	tʂʰə̃e	②沉陈尘臣辰娠澄橙娠成城乘承丞骋③惩逞④趁
ʂə̃	ʂə̃e	①琛深森参（人～）身申伸②神晨③审婶沈④甚葚渗肾慎圣盛剩胜蜃
ʐə̃	ʐə̃e	①扔②壬任（姓）人仁仍③刃忍韧④任（责～）妊认
ə̃	Øə̃e	①恩④硬
		ĩ
pĩ	pĩ	①彬宾槟殡鬓冰兵傧③禀丙柄秉饼并（合～）④病并（～且）
pʰĩ	pʰĩ	①拼姘②贫频凭平评萍瓶屏③品④聘
mĩ	mĩ	②明盟萌鸣名茗铭冥螟民③闽悯闵敏泯皿④命
tĩ	tĩ	①丁钉靪疔③顶鼎④钉（～住）订定锭
tʰĩ	tʰĩ	①听汀厅②亭停廷庭蜓（蜻～）③艇挺④听（探～）
nĩ	nĩ	②宁柠泞凝③拧④佞
lĩ	lĩ	①拎②林淋临邻鳞燐陵凌菱零铃灵伶③凛廪领岭④赁吝令
tɕĩ	tɕĩ	①今金禁（～不住）襟津巾斤筋京鲸荆精睛（眼～）晶旌经矜均钧君军③锦紧仅谨景警井颈④禁（～止）进晋尽劲近竞兢茎敬静净径侭俊竣窘菌郡竟境镜
tɕʰĩ	tɕʰĩ	①侵浸钦亲卿青清蜻轻倾②琴禽擒秦勤芹擎情晴群裙琼③寝请顷④亲（～家）庆磬
ɕĩ	ɕĩ	①心辛新薪欣兴（～旺）星腥馨炘昕薰熏勋②行形型刑旬殉荀询循巡③省（反～）醒④信汛迅衅兴（高～）杏幸性姓讯训
ĩ	Øĩ	①音阴荫窨因姻殷英鹰莺婴樱鹦缨晕②淫银寅蝇迎盈赢萤营茔荧吟龈匀云耘芸郧③饮引影颖隐允尹陨④印应映运韵熨孕
		uə̃e
tuə̃	tuə̃e	①蹲敦墩③盹④饨（馄～）盾遁顿钝
tʰuə̃	tʰuə̃e	①吞饨（又）②屯囤豚臀④褪（～下来）蜕（～皮）
nuə̃	nuə̃e	④嫩
luə̃	luə̃e	②伦仑沦轮④论囵
kuə̃	kuə̃e	③滚④棍
kʰuə̃	kʰuə̃e	①昆崑坤②□（～鸡蛋）③捆④困
xuə̃	xuə̃e	①昏婚荤晕②魂馄（～饨）横④混
tsuə̃	tsuə̃e	①尊遵
tsʰuə̃	tsʰuə̃e	①村皴②存③忖④寸
suə̃	suə̃e	①孙③损笋
tʂuə̃	tʂuə̃e	①谆肫③准
tʂʰuə̃	tʂʰuə̃e	①春椿③蠢
ʂuə̃	ʂuə̃e	②唇纯淳绳③瞬④顺舜
ʐuə̃	ʐuə̃e	④闰润
uə̃	Øuə̃e	①温瘟②文蚊纹闻雯③稳吻刎紊④问
		iᴀ̃
niã	niᴀ̃	①娘（姑～）孃（二～）②娘（新～）④酿
liã	liᴀ̃	②良粮梁粱凉量（～长短）③两辆④亮量（数～）谅
tɕiã	tɕiᴀ̃	①将（～来）浆疆薑僵姜江③将奖桨讲④酱将（大～）匠降（下～）犟
tɕʰiã	tɕʰiᴀ̃	①枪羌腔戕②墙强（～弱）③抢强（勉～）④呛炝
ɕiã	ɕiᴀ̃	①相（～互）箱厢襄镶香乡②详祥降（～服）③想享响④象像向项（文）巷相（～貌）
iã	Øiᴀ̃	①央秧殃②羊洋阳杨扬③仰养痒④样恙漾
		oɲ
poŋ	poɲ	①崩④迸
pʰoŋ	pʰoɲ	②棚蓬篷③捧④碰
moŋ	moɲ	①蒙（～人）②蒙（～古）朦濛③猛懵④孟梦
foŋ	foɲ	①风枫疯丰封峰蜂锋②冯缝（～衣服）逢③讽④凤缝（一条～）奉俸
toŋ	toɲ	①东冬③董懂④冻栋动洞
tʰoŋ	tʰoɲ	①通②同桐筒铜童瞳③桶捅统④痛
noŋ	noɲ	②农浓侬脓
loŋ	loɲ	①聋②龙笼隆③陇陇垅④弄
koŋ	koɲ	①公工攻功弓宫躬恭供③汞拱（～手）④贡共供（～养）
kʰoŋ	kʰoɲ	①空（～虚）③孔恐④控空（～缺）
xoŋ	xoɲ	①轰揈烘（～干）②弘宏洪红虹鸿泓③轰（又）哄（～骗）④閧
tsoŋ	tsoɲ	①宗棕综鬃③总④粽纵
tsʰoŋ	tsʰoɲ	①聪葱囱②从丛④冲（～鼻子）
soŋ	soɲ	①松鬆嵩②㞞③耸④送宋诵颂讼
tʂoŋ	tʂoɲ	①中（当～）忠盅钟鍾终③冢④重（轻～）种（～树）仲众中（射～）
tʂʰoŋ	tʂʰoɲ	①充冲舂②重（～复）虫③宠④铳
ʐoŋ	ʐoɲ	②戎绒茸③冗
oŋ	Øoɲ	①翁嗡④瓮
		ioɲ
tɕioŋ	tɕioɲ	③炯迥
tɕʰioŋ	tɕʰioɲ	②穷穹
ɕioŋ	ɕioɲ	①兄胸凶②熊雄
ioŋ	Øioɲ	①雍拥庸镛②融容荣③甬勇涌永④用佣咏詠泳
