
3	3 2	4 5	5 2	2 4	1 5	 2	4

pi1	卑碑蜱（牛~）啤（~酒）婢悲啡（咖~）篦（~麻）
pi2	脾（~胃）啤（又音，~酒）毗（~鄰）枇（~杷）琵（~琶）蚍（~蜉）
pi3	比妣（考~）彼匕（~首）否（符鄙切，~極泰來）
pi4	被（~動）
pi5	備痹（麻~）庇保~(保祐)祕秘泌閉避臂
pʰi1	披丕胚坯砒（~霜）紕（~漏）
pʰi2	皮疲（~勞）
pʰi3	鄙（~視）痞（地~）否（又音，符鄙切，~極泰來）庀（堅~：結疤)
pi5	屁鼻譬（~如）
bi1	微（笑~~）
bi2	微（又音,~~風）薇眉楣湄嵋瀰（~漫）咪（貓~）維（~生素）
bi3	米美尾娓
bi5	未味昧沬（沈~：潛水)媚寐
ti1	知（通~）蜘（~蛛）
ti2	池馳弛遲墀（靈~）持（記～：記性)
ti3	抵底
ti4	弟痔治底（又音，~時：何時)
ti5	置戴（~帽）蒂締致稚（幼~）滯地（土~:土地爺)
tʰi1	黐（粘~~：很粘)笞（鞭~）
tʰi2	啼苔（青~苔鮮)
tʰi3	恥
tʰi5	涕
li1	哩（阿~：嬌滴々)
li2	厘狸離（分~）漓（~江丿籬犁（伊~：地名)梨兒而
li3	里俚理鯉浬娌李裏餌
li5	字詈利
tsi1	之芝□（女陰）支肢枝脂
tsi2	薺（美~：荸薺)糍（冬米~：水磨年糕)
tsi3	止址趾子籽旨指只紫姊
tsi4	舐
tsi5	志誌痣至
tsʰi1	鰓癡（白~）
tsʰi2	持（~久）
tsʰi3	齒
tsʰi4	市
tsʰi5	試（~一擺：試一下)弑（~君）翅剌（~殺）食（~牛：養牛)飼（~牛：養牛)幟
si1	詩屍絲鷥施俬（家~）司（公~）斯思（相~）
si2	時鰣（~魚）辭（~職）匙
si3	死始矢
si4	是舐序（~大儂：長輩)市柿氏
si5	世（一~依：一輩子)四肆試寺侍（~從）恃嗜（~好）示視豉（豆~）勢（北~：北方)翅似姒
ki1	基箕支枝肢吱技（中~）妓（娼~）幾（居履切）譏饑機肌姬奇（居宜切，~零）
ki2	其棋琪淇期旗祁祈奇（渠羈切，~怪）
ki3	己紀杞幾（居豨切）指（~天~地）
ki4	陭（陡峭）
ki5	既（~然）記忌（做~：祭祖宗)計（夥~）痣騎（單~）寄
kʰi1	欺攲（不正ʰ）蹊（~蹺）
kʰi2	蜞（蜈~：螞蟥)枇（又音）琵（又音）
kʰi3	齒豈起
kʰi4	柿
kʰi5	氣（天~）汽棄器企
ɡi2	疑儀宜誼
gi3	擬蟻
gi5	義蟻毅
hi1	希稀犧熙嘻熹禧嬉
hi3	喜
hi4	耳（~仔：耳)
hi5	戲
i1	衣依伊醫
i2	夷姨胰怡貽飴頤（~和園)彝（~族）維（~持）
i3	椅倚已以矣
i4	預（參預）
i5	意易（容~）異（~讀）肆（~業）□（疒益）

u
pu2	炰（把食物直接放到火堆裏燒烤;~芋：烤芋頭)[瓠]南瓜一類的瓜菜
pu4	婦（新~：媳婦)
pu5	富伏（孵也）
pʰu2	浮[烰]（煠）芙（~蓉花）葡
pʰu3	殕（生~：發黴)
pʰu	[噗]（爪仔~去：鳥飛走了)
bu2	無蕪巫誣（加~：誣賴)
bu3	武母姆（保~）拇撫
bu4	[潕]（~血：吐血)
bu5	務霧鶩
tu1	堆推（~車）蛛誅株
tu2	廚（~房）躕（牛~：不講道理)
tu3	拄（頂著）
tu5	注（九~：賭注)
tʰu2	躇（磨洋工）
lu1	[揄]（亂~：亂放)
lu2	儒孺蠕俞瑜榆愉渝逾
lu3	乳愈（~來~好）
lu4	裕（高~：富裕)
lu5	喻（家~戶曉）裕（又音，富~）
tsu1	朱珠硃株（又音）洙侏（~儒）蛛（又音）誅（又音）
tsu2	[咮]（呼雞的聲音）
tsu3	主
tsu4	聚柱（支~）
tsu5	鑄蛀（~蟲）注註住駐
tsʰu1	趨（~向）
tsʰu2	雛
tsʰu3	取娶（此主切，~親）
tsʰu4	□（滑倒）
tsʰu5	厝趣處（又音，～決）
su1	輸須雷樞（~紐）鬚（~眉）
su2	殊薯
su3	璽署（~名）曙（~色）墅（別～）鼠
su4	豎
su1	樹（~立）戍（~邊）
ku1	龜痀（瘨~：駝背)拘駒
ku2	瞿（姓）
ku3	久韭（~菜）
ku4	舅（大~）
ku5	灸句舊具俱懼
kʰu1	區嶇軀驅丘坵邱
kʰu2	跔（蹲也）
kʰu4	柩臼（石~）
gu2	牛愚寓娛
gu5	寓（又音）遇（待~）
hu1	夫伕膚麩灰（火~：艸木灰)	敷（~藥）
hu2	扶芙孚俘浮符苻
hu3	府俯腑甫脯輔釜（~底抽薪）斧（~正）腐撫（又音）
hu4	婦（~女）阜父
hu5	赴訃（~告）付咐附駙賦富（~裕）副竅煦傅（師~）埠負腐（又音，豆~）伏
u1	汙迂
u2	俞瑜揄愉渝逾
u3	雨（穀~）禹羽宇愈
u4	有
u5	煦（~燒：取暖)汙（又）裕喻芋

ɯ
tɯ1	豬
tu2	除（開~）[鋤]（~頭）躇（又音，躊～）
tɯ4	待（在也）佇（~立）苧（~麻）
tɯ5	著箸	r
tʰɯ2	[鋤]（又音，~艸）
tu3	儲貯
lɯ2	驢如茹
lɯ3	女汝（爾也）旅屢呂侶鋁
lɯ4	呂（姓）倡錯慮（顧~）濾（過~）
tsɯ1	書資姿茲滋淄輜孜諸
tsɯ2	慈磁蜍薯（番~)
tsɯ3	煮子（~女）籽（~棉）仔（~細）梓紫紙
tsɯ5	自字蔗（茭~：裝物用的艸袋)
tsʰɯ1	雌蛆（車~：孑孓)舒（~艸：鋪艸)疵癡
tsʰɯ	2	□（著迷）
tsʰɯ3	鼠此（如~）
tsʰɯ5	次處（~長）
sɯ1	私斯思（又音）司（~令）書（~法）師（老~）獅螄（螺~）
sɯ2	祠詞辭（修~）徐蜍（蟾~）
sɯ3	史使（~喚）駛（~過）死暑徙（遷~）
sɯ4	士仕祀序柿似（又音，相~）姒（又音）
sɯ5	賜肆四泗駟（~馬難追）食（~料）飼（~料）嗣伺（~機）事（故~）庶（~民）敘（~述）
kɯ1	居裾車（九魚切，~馬礮）
kɯ2	渠
kɯ3	舉矩（規~）
kɯ4	巨（~大）拒（抗~）距炬（火~）
kɯ5	鋸據踞
kʰɯ5	去
gɯ3	語
gɯ4	[齬]膩也
gɯ5	御（~林軍）
hɯ1	圩（～日：趕集的日子)虛噓墟
hɯ2	魚漁
hɯ3	許（允~）
ɯ1	於淤
ɯ2	餘？予盂
ɯ與（參~）予（又音，給予）
ɯ飫（膩也）豫譽

a
pa1	巴芭疤笆靶（打~）
pa2	父爸鈀琶杷扒
pa3	飽把（~關）
pa4	罷（~工）
pa5	伯霸壩豹耙（田器）爸父（又音,阿~）
pʰa1	葩（量詞:一~燈即一支燈)脬（卵~：膀胱)拋（~輾斗：翻筋斗)
pʰa2	爬（~行）
ba2	麻（~雀）貓（野~）
ba5	密（嚴密）碼（量詞:一~布）
ta1	凋（乾燥）【礁]（白~：地名)大（~家：婆)諸（~夫：男性)
ta2	朷（枯~：乾枯)
ta3	□（兒語，喫:~~）
ta5	奈（無~何：無可奈何)
tʰa5	（以長而尖的東西挑取）虻（海蜇）
1	a1	拉啦
la2	膋（脂肪:點燈~：點油燈)撈
la4	鬧（吵~：吵鬧)撓
tsa1	查（檢查）渣（~滓）
tsa3	早（~春）
tsa5	灹詐榨昨（~日)
tsʰa1	差（反~）叉杈衩釵岔
tsʰa2	柴查（又音，~鋪）樵材茶
tsʰa3	吵炒
tsʰa5	鈔（美~：美元）
sa1	沙砂紗痧鯊裟莎
sa2	傻
sa3	灑（~淚）
sa5	[嗄]好也
ka1	家傢加笳袈嘉膠鉸（~剪：剪刀)佳虼（~蚤：跳蚤)交（~定：預定)
ka2	[拁]（~椅桌：搬桌椅)
ka3	假絞鉸（又音，~鏈）賈（姓）
ka4	齩
ka5	架駕稼嫁（~接）教（~書）漖（稀也）價（~值）校（~場）
kʰa1	骹（腳也）奇（居宜切,又音，~數）迦尻（~川：屁股)
kʰa騎（~馬）
kʰa4	:徛（站立也）
kʰa3	巧（花言~語）
kʰa5	敲（苦教切，~鼓）較（~好）
ga2	牙芽伢訝衙涯（天~海角）
ga5	訝
ha1	哈呵
ha2	霞蝦瑕
ha4	下（胡駕切，~降）廈（大~）
ha5	孝（帶~）暇（閒~：空閒)
a1	阿（~兄)啊（嘆詞）鴉亞（~洲）啞（《集韻》於加切，～巴）
a3	也[仔]（常用詞尾:爪~鳥兒)	阿（又音，~姊）啞（烏下切，~鈴）
a5	亞（又音，~軍）


tia1	爹
lia3	惹（~禍）
lia4	爾（安~：這樣)
tsia1	遮（~醜）
tsia3	姐（小~）者（行~）
tsia5	蔗鷓（~鴣）
tsʰia1	車（尺遮切，汽~）硨（~倒：推倒)奢（~侈）
tsʰia2	斜（~紋布）
tsʰia5	笡（陡也）
sia1	賒
sia2	邪斜（~陽）蛇石（~榴）
sia3	寫
sia4	社
siay5	瀉赦卸舍捨射謝麝（~香）
kia4	陭（陡坡）
kia5	寄
gia2	鵝
hia1	靴
hia4	瓦蟻
ia1	埃（轟~：灰塵飛揚)
ia2	爺耶揶
ia3	野冶也猶（~未：還沒有)
ia4	也（又音，~許）掖（撒也）
ia5	疒益（厭倦）夜

ua
pua5	簸
pʰua5	破
bua2	磨（莫婆切，~刀）
tua1	舵
tua2	汰（《集韻》唐何切，淘米去沙）tua5	帶（皮~）大駐（住也）
tʰua1	拖
tʰua5	汰（他蓋切,~衫褲：淘衣服)
lua4	偌（~濟：多少)
lua5	賴（姓）
tsua1	抓
tsua	2	蛇
tsua3	紙
tsua5	迣（一~：一趟)誓（呪~：發誓)
tsʰua5	蔡娶（七句切，~嫁）（帶;娶:~路卽帶路;~姥即娶老婆)
sua1	沙砂鯊刷（~鞋）
sua3	徙（~動：迻動)
sua4	唰（憖~~：喜歡得很)
sua5	世（連續，連接）
kua1	瓜歌柯（姓）
kua	[何]（~樹：木荷)
kua3	寡
kua5	挂掛卦蓋芥（~菜）過（罪~）
kʰua1	夸誇垮
kʰua3	可（小~：稍微)
kua5	沙可（放置）胯挎
gua3	我[唔]（歎記,表驚異）瓦（寧～為~存）
gua5	外（~口：外頭)
hua1	花（~~吐界）
hua2	華樺鏵鏵嘩（~變）
hua4	嘩（又音，水流~~：水嘩嘩流)
hua5	化（文~）畫
ua1	哇娃窪挖（~苦）
ua2	何（無奈~）
ua3	倚（依靠）瓦（又音，~解）
ua5	倚（又音，扶住）

ɔ
pɔ1	哺（下~：下午)埔（達~：地名)夫（丈~：男性)菠（~蔆菜：菠菜)埠
pɔ2	捕（逮~）袍（龍~）
pɔ3	補脯（脈~：肉乾)斧（~頭）保（~庇）
pɔ4	部埠又音，蚌~(地名)
pɔ5	布怖播鄱傅（姓）步
pʰɔ1	鋪
pʰɔ2	菩（~薩）莆（~田：地名)扶（~儂：拍馬屁)
pʰɔ3	普譜（畫~）頗（廉~)浦（~口：地名)圃（花~）簿（~仔：本子)
pʰɔ5	舗（里程單位，十里為一鋪）破（~壞）
摸（~底）
bɔ4	模（規~）漠（沙~）摸（又音）
bɔ5	畝牡某姥妻也姆拇
bɔ幕券~捐慕（羨~）戊~戍f1	都多~謝リ
tɔ2	徒（~弟）途塗（糊~）茶（如火如~）圖廚（~子)濤逃葡陀佗華~(歷史人名)鴕
tɔ3	堵賭睹屠肚（當古切，腹~：肚子)倒（不~翁）禱
tɔ4	肚（徙占切，腸~）杜道（無~）稻
tɔ5	妬到（報~）導（引~）盜株度渡
tʰɔ1	滔拖（~拉機）
tʰɔ2	塗(又音，泥上)
tʰɔ3	土(~洋結合)
tʰɔ5	吐唾(~棄)兔與(被，介詞)
lɔ1	嘍(語氣詞，相當“了”)
lɔ2	奴爐蘆(~葦)廬(~山)鸕(~鶿)勞(~動)撈癆(肺~)牢(~靠)
lɔ3	魯姓櫓(揺~)虜(俘~)鹵(~鴨)裸
1	ɔ4	鹵(鹽~)
lɔ5	路露鷺(白~鷥:白鷺)賂(賄~)漏陋
tsɔ1	租遭(~遇)
tsɔ2	曹槽
tsɔ3	祖組阻左(~右)烏(~棗)
tsɔ5	助
tsʰɔ1	粗初(~中)搓(~板)操(~勞)
sʰɔ3	楚(清~)礎(基~)艸(~木皆兵	)
sʰɔ5	醋措(~施)錯操(又音，~行)躁(急~)挫糙
sɔ1	蘇酥梳疏(~遠)蔬(~菜)騷搔
sɔ2	󽀩(~腰:背部微駝)
sɔ3	所
sɔ5	素(元~)訴(~苦)數(~學)掃(大~除)燥嗽漱
kɔ1	姑沽菇辜(~負)鴣(鷓~)羔糕膏高(~中)戈(~甲:兵器戰甲)孤(~立)歌(~頌)
kɔ2	糊
kɔ3	古詁(訓~)估牯(牛~:牛犢)股鼓蠱(~惑人心)果裹(包~)稿狗
kɔ5	故(~鄉)固(堅~)錮(禁~)告(廣~)雇顧過記~夠
kʰɔ1	箍(金~棒)筘(竹~:竹筒)瞘(目~：眼圈)呼(~雞:叫雞)枯(又音，海~石爛)柯科
kʰɔ2	糊(又音，維持)
kʰɔ3	苦許(姓)
kʰɔ5	靠(可~)庫褲課犒
gɔ2	吳蜈吾梧(~桐)
gɔ3	五(~愛)伍(隊~)午忤(~逆)仵(~作)
gɔ4	五(第~)伍(“五”的大寫)
gɔ5	誤(耽~)
hɔ1	呼(歡~)乎（幾~）
hɔ2	胡湖瑚糊蝴胡鬍(~鬚)壺狐(~狸)弧(~度)不和(戶戈切，~平)何(~必)豪(~傑:熱心)
hɔ3	虎唬滸
hɔ4	雨禍
hɔ5	戶滬護戽獲貨號(綽~)互
ɔ1	烏嗚鎢鍋萵窩
ɔ2	壺胡湖瑚(珊~)盂
ɔ3	搗(扒拉:~塗:扒拉土)
ɔ5	芋(~頭)


po1	菠~歲玻(~璃)褒(~貶)
po2	婆
po3	保堡寶鴇跛
po5	報簸(顛~)
pʰo1	波(水~)坡(山~)
pʰo4	抱
pʰo5	騰(~圓:肉丸子)
bo2	無
bo5	磨(模臥切，石~)帽
to1	刀(菜~)
to2	駝(駱~)鴕(~鳥)陀佗砣逃(~避)萄(葡~)桃(陽~)汰(«集韻》店們切，~井:掏井)
to3	禱(祈~)倒(~閉)哪(~去)朵垛躲
to4	道(~理)惰(~性)舵
to5	倒(又音，~水)馱
tʰo1	拖(又音，~~拉拉)叨(~鵝、鴨等伸頭齩東西)他它偷(~情)
tʰo2	桃(又音)佗(又音，佚~:玩耍)
tʰo3	討
tʰo5	套妥(~當)
1	o1	囉(~嗦	)
1	o2	羅鑼邏籮牢醪(渾濁)螺
lo3	腦娜咾(阿~:稱讚)
lo5	□(喫;揍)
tso1	糟(~心:煩心)遭鄒(姓)
tso2	槽
tso3	棗左(~輪	)
tso4	造皂(青紅~白)坐(滿~)座(量詞:一~山)
tso5	做~空(搗鬼)奏(~書)驟(步~)皺
tsʰo1	臊(臭~:腥味)麤(~桶：馬桶)
tsʰo3	艸(又音，甘~)楚(清~)
tsʰo5	錯挫(~折)措(~手不及)糙(~	米)
so1	搜搓臊唆(~使)悛嗦(啰~)騒(風~)搔
so2	趖(爬行)
so3	鎖瑣叟嫂
so5	燥(~熱)躁掃(又，糞~:垃圾)瘦
ko1	膏(石~)羔(羊~)糕髙(~麗薓)辜(姓)哥歌(又音)
ko2	㩝(竹~：竹籠)
ko4	[膏](滾動)
ko3	稿
ko5	箇(~體戶)告(又音，被~)_[划](~船)
kʰo1	柯(樹名)科(又音)苛(~求)
kʰo2	□(擺架子刁難)
kʰo3	洘(濃也)可
kʰo5	靠(~水:壓水)課𣹇(~淺:擱~)
go2	遨
go5	餓
ho1	呵(吆喝以推銷)苛
ho2	河荷(~蘭)何(又音)壕和(胡臥切，一唱一~)
ho3	好(呼晧切，~漢)
ho5	賀(慶~)號(~召)荷(薄~)
o1	阿(於何切，吹噓:自己~:自我吹噓)婀(~娜)鷗歐撾(老~:國名)
o2	河(~溪:銀河)壕(戰~)蠔(~乾:牡蠣的乾肉)
o3	襖阿(倚可切)
o5	奧澳懊

io
pio1	鏢膘摽(~笑:戲謔)鰾標(指~)
pio3	表(報~)裱
pio4	薸(萍類)飄
pio3	剖(解~)
pʰio5	票(門~)
bio2	謀貿描(~圖)
bio3	母(父~)
bio5	廟
tio1	兜
tio2	潮(~州)投跳(物體由於彈性作用突然向上迻動:新毬~真懸:新毬跳得很高)長(直良切，~泰地名)
tio3	斗蚪
tio4	趙(姓)
tio釣銚(鐵~:炒菜鍋)豆逗痘鬥~爭)竇掉(抖也)讀(《集韻》大透切，句~)
tʰio1	挑(~花)偷
tʰio2	頭跳(又音，反彈也)
tʰio5	糶(~米)透
lio1	瞜(偷看)
lio4	撩(~油:去掉水上的浮油)樓
lio3	摟蓏(瓜~:乾的瓜)
1	io5	溺尿漏陋[躼](高也)
tsio1	招(~生)椒(胡~)蕉(巴~)
tsio3	少
tsio5	照醮(做~:一種佛事活動)
tsʰio1	[𤞚]（起~：動物發情)
tsʰio5	笑俏（~市：銷路好)
sio1	燒霄（雲~地名)蕭（姓）
sio	[𦯐]（慢也;食物軟而下垂的樣子）
sio3	小（~學）
kio1	勾溝鉤購
kio2	喬橋茄
kio3	枸（~杞）
kio4	□（~中哥：用中指戳人，以示侮辱）
kio5	叫轎構
kʰio3	口（人~）
kio5	5竅（做~：一種意欲害人的迷信手段)扣（~除）寇
gio2	蟯（蚌類的一種）
gio3	偶藕
gio4	藠（鹵~：藠頭)
gio5	［𨎬］（撐住）
hio1	靴
hio2	侯（閩~）喉（~舌）
hio3	否（方久切，~定）吼
hio4	厚（忠~）后（皇~）
hio5	5候（氣~）
io1	腰（~鼓）唷邀
io2	搖窯
io3	舀（~水）毆（~落去：棍棒橫擊)
io	5	鷂（放~：放風箏)

ə
pə1	飛
pə2	賠（~款）
pə3	□（~食：使用手段騙取)
pə4	倍
pə5	壩（水~）焙（~凋：烘乾)背佩
pə1	坯胚
phə2	皮（牛~）被（~面）
pʰə配（~菜：就菜)𥯟（柴~花：刨木	花)
bə1	微（雨~~：雨濛濛)
bə2	糜（粥也）
bə3	尾美（~蝶：蝴蝶)
bə5	未妹
tə	l䭔（麪粉~：麪粉煠成的餅)
tə3	垛（短也）[短]（短也）
tə5	桗（量詞一~：一塊)綴（跟:~伊行即跟他走)袋（布~）戴（又音,姓）埭（陳~：地名)代（朝~）
tʰə1	推（又音，把事情推掉）胎
tʰə5	退（~步）
lə2	螺（海~）腡(指紋的斗)挼（揉也）
lə3	儡（嘉~：傀儡)𠼱（副詞:~唱歌即正在唱歌)
lo5	𠼱（又音）
tsə1	災（雞~：雞瘟)
tsə4	坐座罪（~過）
tsə5	晬（度~：周歲)
tsʰə1	吹（~風）炊（蒸也）
tsʰə2	箠（小棍）
tsʰə3	髓□（~尾：結尾)
tsʰə5	脆（尋找）
tshə2	垂（消~：消瘦)
sə5	稅賽（~緊：比快)
kə3	果粿（一種米制食品）
kə5	過（又音，~去）髻
kʰə1	科蝌（~蚪）
kʰə2	瘸（~手：手殘廢)葵（~扇）
khə3	□（擋住或架住）
gə2	譌（~儂：賴人)㤉（~神：討	厭)
hə1	灰（又音，白~）
hə2	和（戶戈切）回（~批：回信)
hə3	火夥賄（家~：家產)
hə5	貨（~物）歲（~指：歲數)會（黃	外切,分~：分辯)
ə1	禍鍋窩萵倭
ə5	穢（傳染;弄髒）

e
pe2	爬（ʰ~山）琶（琵~）杷（枇~）鈀（~粟：扒穀子)
pe3	把（火~）靶（~場）
pe4	爸父（又音,老~：父親)
pe5	幣蔽斃弊陛（~下）
pʰe5	帕
be2	迷（~信）謎（~語）
be3	馬碼（~頭）螞（~蟻）瑪（~瑙）
te1	低
te2	茶（紅~）題蹄
te3	[第]最
te	4	弟
te5	帝第地（~雷）滯（~留）
tʰe1	篪（~椅：太師椅)虒刀梯
tʰe2	堤提（~拔）
tʰe3	體（~育）
tʰe5	䖳（水母）屜替涕剃
1	e1	咧（擬聲詞:哩哩~~）
le2	黎（~明）麗（高~：今朝鮮的舊	稱)梨（又音）璃（玻~）
1	e3	禮
le4	□（無~：有氣無力)
1	e5	例厲（嚴~）勵（鼓~）隷（奴~）麗（美~）儷（~伉）淚
tse1	渣（豆~）
tse2	齊臍（~帶）
tse3	濟（《集韻》子禮切,~南：地名)
tse5	祭（~天）際（國~）制（~法）製（~服）債（欠~）寨（山~）濟（子計切，救~）儕
tsʰe1	妻淒叉杈釵差(出~	)
tsʰe3	撦(~~:差不多)
tsʰe5	切(千結切，一~)廁(~所)
se1	紗痧(著~:發音)裟砂(硼~)西(~瓜)
se2	垂(又音，瀾~:圍嘴兒)
se3	洗
se5	世(~界)勢(~力)逝誓(宣~	)
ke1	加(~減)家傢雞奎
ke2	枷
ke3	假
ke4	下(太~:太低)[低]
ke5	計繼嫁架駕芥(又音，~藍)菜)價(物~)
kʰe1	溪(明~:地名)
kʰe3	啓	啟
kʰe5	下(又音，~𠼱:放著)
ge2	衙牙芽伢倪(端~)[箇](即~:這箇)
ge5	藝毅
he1	瘕(~痀:哮喘)
he2	蝦霞
he4	下(又音，~力:用力)暇(放~:放學)
he5	夏(~天)系
e2	兮(我~:我的)
e3	啞(~口:啞巴)喂(嘆詞)
e4	下(又音，~面)會(黃外切，又音，~寫字:能寫字)解(胡買切，明白,懂得:~英語)廈(~門:地名 實即下門之雅化)
e5	下(又音，動量詞:踢一~)

ue
pue1	杯(荼~)𤖯(鞋~:木屐)
pue2	培賠(~禮)陪裴
pue4	倍
pue5	貝輩背(~叛)焙佩
pʰue1	批(~信:書信)裴(又音，~巷：巷名)
pʰue3	䫌(面~:臉頰)
pue5	配(~合)稗
buel[踒](躡手躡腳，躲躲閃閃)
bue3	買
bue1	[𣍐]不會
bue5	賣
tue2	題(~詩)蹄(馬~)
tue3	底貯
tue	苧(~仔素：苧麻繩)
tue5	地(又音，天~)兌(~現)蛻綴
tʰue1	𠞄(~刀:刨刀)䈕(金~:金釵)[釵](金~)
tʰue3	體（樣子）
tʰue5	退替蛻(又音，蟬~:蟬売)
lue2	犁
lue3	詈(~儂:罵人)
lu4	[銇]扒出
lue5	銳芮(姓)內(~部)
tsue2	齊（整~）
tsue4	罪
tsue5	最做(~工)濟(多也)
tsʰue1	初(~一)妻(夫~)
tsʰue2	摧(輕微摩擦)
tsʰue5	粞(米麪)切(千結切	)
sue1	衰梳(~頭)蔬(菜~:蔬菜)疏
sue2	□(輕輕擦過)
Sue3	洗(~手)黍(番~:高粱)
sue5	帥細(小也)歲說(舒銳切,遊~)
kue1	雞街(~路:街道)瓜(菜~	)
kue2	鮭(醃浸而成的水產品)
kue3	改(~正)解(佳買切)
kue5	會(古外切,~計)檜繪儈膾	劊疥(生~:生疥瘡)界(四~走:到處跑)解(古隘切，~送:押送)
kʰue1	溪盔恢(~復)魁稽
kʰue5	契(~兄:情夫)喫(啃也)	快(~便:方便)
gue2	倪(姓)
gue5	藝(做~:消遣)外(~甥)
huel花(紅~)灰(~心)恢(~復)
hue2	回(~民)茴洄
hue3	悔(~恨)賄晦
hue4	匯(~合)蟹
hue5	廢化(徳~:地名)	會(黃外切，~合)繪(描~)穢
ue1	挨(~麪:磨麪)唉
ue2	鞵
ue3	矮倭(又音)
uey	衛畫(~圖)話穢(又音，汙~	)

iu
piu1	彪
biu2	繆(未雨先~)
biu5	謬(~論)
tiu1	丟
tiu2	綢稠(~密)籌(~備)
tiu3	肘
tiu4	紂(桀~)宙(宇~)
tiu5	晝(~夜)秞(稻子)住(~厝:住房)
tiu1	抽
tʰiu3	醜？
liu1	溜(尾~:尾巴)蹓(~點)
1	iu2	留瘤榴(石~)劉流(河~)硫(~磺)琉(~璃瓦)柔（溫~）揉(擦洗)
liu3	柳扭紐女妞
liu5	餾(把年糕之類再加熱)
tsiu1	周舟州(泉~)洲(亞~)珠（目~）
tsiu3	酒守(~寡)帚
tsiu5	 咒(誓：發誓)就(高~)蛀(~齒)
tsʰiu1	秋鰍鞦(~韆)鬚(胡~)羞
tsʰiu2	囚泅(~渡)愁
tsʰiu3	手帚(掃~)
tsʰiu5	樹
siu1	修收羞(害~)
siu2	仇囚(~犯)泅(~水)售(銷~)	酬(報~)
siu3	守首手
siu4	受
siu5	秀繡鏽袖獸壽授狩岫雞(~:雞窩)
kiu1	勼（卷縮）鬮
kiu2	求俅毬逑毬裘
kiu3	九久玖韭
kiu4	咎(既往不~)舅(國~)臼柩(靈~)
kiu5	救灸究(硏~)舊(故~)
kʰiu1	丘邱圻蚯(~蚓)
kʰiu	虯(~筋:抽筋)
kiu3	搝(~直:拉直)
kʰiu5	䊆(飯誠~:飯粒很韌)
giu2	牛
giu3	扭(~直:拉直)
hiul休
hiu2	裘（棉~：棉襖）
hiu3	朽
hiu5	嗅(~覺)溴
iu1	優憂幽攸(~關)悠(~久)
iu	2	尤猶由油郵遊遊魷(~魚)	酋猷
iu3	友有酉莠(良~不分)誘(引~)
iu5	幼黝鈾釉柚右佑又

ui
pui2	肥
pui5	痱沸吠
pʰui5	屁(放~)呸(~痰：吐痰)
bui1	微(又音，~~:眯著眼睛)
tui1	追䭔堆
tui2	捶
tui5	對隊墜碓
tʰui梯(樓~)推(~托)
tʰui2	槌鎚錘
tʰui3	腿
tʰui5	墜(~落去:墜下去)替(又音 ~包:調包)
lui1	鐳(銅板)
lui2	雷鐳(又音，一種金屬元素)擂檑
lui1	蕊(花~)壘(堡~)儡(傀~)磊(光明~落)累(積~)蕾
lui5	類淚（又）
tsuil錐(立~之地)椎脊(~骨)
tsui2	摧(又音，~甘蔗:切甘蔗)
tsui3	水(~溝)
tsui5	醉贅(入~)綴(後~)
tsui1	崔(姓)催摧(~毀)吹(~牛)炊(~煙)
tsʰui2	箠
tsʰui3	璀(~璨)
tsʰui5	翠(青~)碎(粉~)粹(精~)悴(憔~)脆(~弱)喙(嘴巴)
sui1	綏(~遠:地名)雖(~然)蓑(棕~:蓑衣)睢
sui2	隋隨(~便)誰垂箠(又音)陲(	邊~）
sui3	水(雨~)髓(精~)
sui5	穗瑞遂邃隧燧
kui1	歸龜規(~則)閨(~房)圭硅(臺灣曰矽)機(布~:織布機)奎(又音,~寧:即金雞納霜，藥名)
kui2	逵葵(向日~)
kui3	鬼詭(~計)宄(奸~)幾(居稀切,~歲:多大歲數)
kui4	跪
kui5	桂掛(~衫：掛衣服)季櫃貴
kʰui1	虧開(~門)窺(~探)
kʰuit	睽(眾目~~)逵(又音)葵(又音)
kʰui?傀(~儡)軌
kʰui5	愧(慚~)潰（~爛)氣(出~)
gui2	危(~險	)
gui5	魏
hui1	非菲(~律賓)蜚(~聲世界)揮輝琿暉妃徽麾(~下)
hui2	䀁(陶瓷)肥淝(~水 水名)
hui3	匪誹(~謗)毀(~滅)
hui5	肺費(~用)沸(~點~)疿(~子)翡(~翠)吠(~聲~形)彗(~星)慧(智~)惠(恩~)蕙卉(花~)諱
ui1	威崴崴揻(小挖也)逶(~迤)	胃衣(寒衣)
ui4	維(~護)濰唯帷(~屋運籌)圍	違(~反)遺(~傳)為(作~)桅(~杆)偽(虛~)
ui3	緯偉葦委萎(~縮)諉
ui5	謂蝟渭為(又音，~何)尉(少~)慰(~問)位

ai
pai2	牌排
pai3	擺(搖~)跛(~骹:跛足)ʰ
pai5	拜湃(洶湧澎~)敗
pʰai3	否(符鄙切，~骨:本質不好的人)
pʰai5	派沛(充~)
bai1	□(tsi1	~:女陰)
bai2	埋（~伏）眉楣
bai3	𡬍(火勢或光線微弱)跛(~骹:腳扭傷)
bai5	𥌚(~脈:診脈)覓(~頭路：找工作)
tai1	呆(~板)舵(又音)
tai2	臺[坮](埋也	)
tai3	滓（油~）歹(為非作~	)
tai4	殆(~盡)怠待(擔~)
tai5	帶(地~)戴(愛~)大(~人)逮(~捕)代袋(~鼠)貸玳(~瑁)黛岱事(~志:事情)埭
tʰai1	胎苔(舌~)颱(風~:颱風)𥭘(米~:篩米的工具)
tai2	治(殺也)苔(~鮮)抬
tʰai1	[癩](~𰣻:麻瘋)呔(番~:不明事理)
tʰai2	待(又音，對~)
tʰai5	泰太鈦汰(他蓋切，淘~)態
lai2	來梨
lai4	裏(~外)
lai5	利賴癩
tsai1	災栽齋(書~)知(又音,~影	:知道)哉
tsai4	才財材臍(腹~:肚臍)
tsai3	宰(~相)
tsai4	在
tsai5	載寨再

tsʰai1	猜差(~事)釵
tsʰai2	裁豺柴才(又音,~~:不久前)
tsʰai3	采彩(雲~)睬(理~)踩(~水)
tsʰai5	菜蔡
sai1	師(~傅)獅(石~:地名)篩(~選)西(~北風)腮鰓私(~骹錢:私房錢)
sai]	屎史(姓)使(~勁)駛(駕~員)
sai5	賽塞使(又音，大~)侍(服~)	似(熟~:熟悉)姒(同~:妯娌)婿(妹~:妹夫)
kait	該階(~級)皆(全民~兵)賅(言簡意~)街
kai1	解(佳買切，~放)改(土~)
kai4	□(自己 :“家已”的合音)
kai5	介芥(艸~)疥界(世~)屆尬	(尷~)戒丐(乞~)鈣蓋(~世英雄)解(古隘切，押~)
kʰai1	開(~始)揩(~油)奒
kʰai3	楷(~書)凱(~旋)
kʰai5	概(大~)溉(灌~)
gai2	崖涯(又音)獃(又音，~板)
gai5	礙(妨~)艾(方興未~)
hai1	奒(大也)
hai2	孩(~兒)頦(下~:下巴)械(機~)
hai3	海
hai4	亥駭懈
hai5	害嗐
ai1	哀埃(~及:地名)挨唉
ai3	矮
ai5	愛噯(~仔:嗩呐)隘(關~	)藹(和~)

uai
tsuai2	□(這些)
tsuai4	[跩]扭傷
suai1	[摔]
suai5	[率]輕~
kuai1	乖
kuai3	拐(~騙)柺
kuai4	躗(阻礙，作梗)
kuai5	怪(奇~)
kʰuai3	□(講)
kʰuai5	快(~車)塊(方~)
huai2	懷淮(~河)槐(~樹	)□(那些)
huai5	壞(破~)
uai1	竵
uai3	倚(~倚:一種長形的靠背椅)[竵](行走困難樣子)

au
pau1	包(~工)苞(~米)胞(同~)皰
pau2	包(又音，~公)鮑(姓)庖咆(~哮)
pau3	飽(~滿)
paul4	袌（褱~）
pau5	豹
pʰau1	拋(~磚引玉)枹(柚)刨(~根問底)
pʰau2	袍
pʰau3	跑
pʰau4	抱(又音，~負)
pʰau5	砲泡(~茶)礮袍(又音)
bau1	矛茅蟊(~賊)毛
bau3	卯鉚(~釘)□(估計)
bau5	貌(外~)
tau1	兜(塗骹~:地板)叨(嘮~	)
tau2	投
tau3	斗(量具)搗(~亂)
tau5	罩鬥(~起來:裝起來)晝(食日~:喫午飯)豆逗痘
tʰau1	偷(~營	)
tʰau2	頭潮(又音，水~:地名)
tʰau3	敨(~開:解開)
tʰau5	毒透(~視)
lau	撈(又音)
lau1	樓流留劉
lau3	簍老(~大)佬(~仔:小偷)	[銠](麻~:一種食品)潦(~艸)牢(又音,~固)
lau4	老(又音，~儂:老人)
lau5	漏(~水)鬧(~熱)落(~空:回空)
tsau1	糟(酒~ ~蹋)遭(~罪)㷮(柴~:未燒盡的木頭)
tsau1	巢(黃~)剿(~滅)褿(均勻)
tsau3	走蚤(虼~:跳蚤)找
tsau4	找(又音，~散錢:找零錢)
tsau5	竈奏
tsʰau	抄鈔(現~)操(體~)
tsʰau2	撨(調整:~桌	)嘈
tsʰau3	艸草吵炒
tsʰau5	臭
sau1	𥰱(~聲:聲音沙啞)梢(~殺：搶白)
sau5	掃(~帚)嗽
kau1	交郊蛟(~龍)鉸膠跤（摔~）勾溝鉤
kau2	猴
kau3	狗九玖垢(油~:污垢)口(大舌~:大舌頭，話語不清)齩(程~金)攪
kau5	4厚(~事:多事)
kau5	夠告(到也)[到]到也教(~育)校(~對)較(比~)
kʰau1	薅(~草:除草)鬮(抽~：拈	籤)摳(~耳腔:挖耳朵)敲(口交切，~剝)尻骹
kʰau3	口(又音，出口)
kʰau5	銬(手~)哭扣(~留)
gau2	𠢕(有本事)肴淆
haul□	(~六：虛假)
hau2	豪(文~)嚎矦(拖延;耽擱)
hau3	吼(哭)
hau4	後(~生：年輕)
hau5	孝酵(發~)校(學~)效(見~)耗(消~)候(聽~:等待)
au1	凹鷗歐甌漚(~肥)毆(又音，~殺)嗷(~~叫)
au2	喉嚨~(喉嚨)
au1	拗(折也)嘔
au1	後(又音，~頭)
au5	漚(又音，~屎味:腐臭味)奧	懊(~悔)澳黝(烏~色:黑紫色)

iau
piau1	標（目~）膘鏢摽鰾
piau3	表婊錶裱
pʰiau1	飄漂(~浮)
pʰiau2	嫖瓢剽(~竊)薸
pʰiau5	票(~值)漂(~亮)
biau2	苗(秧~)瞄描錨
biau3	秒眇藐淼
biau5	妙廟
tiau1	刁雕鵰彫貂(~皮)凋(~零)碉	(~堡)
tiau2	條朝（~代)潮調(徒聊切,~和)朷[牢](牛~:牛欄)迢
tiau4	兆（預~）肇（~事）趙
tiau5	調(~查)掉釣召弔吊銚
tʰiau1	挑超(~工:特意，故意)
tʰiau2	鰷(~魚:一種淡水魚)
tʰiau3	窕
tʰiau4	柱(大~)
tʰiau5	跳眺(~望)糶
liaul2	遼燎僚療寮(艸~:小艸房)瞭(~望)鐐(~銬)繚(~繞)撩嘹(~亮)聊(無~)寥(~~無幾)條(椅~:長椅)撓饒嬈(妖~)膋
liau3	了(~事)潦(又音，~艸)爪(手指頭)擾(干~)
liau4	繚(又音，秤~~：秤毫)
liau5	料廖(姓)溺尿爪(又音，用手指抓)
tsiau1	焦蕉礁(~石)招(屈打成~)	昭(~然若揭)釗
tsiau2	樵(~夫)邵(~武:地名)
tsiau3	爪(又音，鳥也)[鳥]鳥也
tsiau5	照(按~)
tsʰiau1	抄(~家)超(~額	)
tsʰiau3	釥(好)
tsʰiau5	俏(俊~)
siau1	肖霄宵消硝梢(下~:賤骨頭)逍(~遙)蕭瀟簫燒
siau2	韶佋(精液)𦯐
siau3	痟(神經病)小(~楷)少(~年)
siau5	數(算~:算賬)笑(見~:不好意思)紹邵(又音，姓)漱(~口水)
kiau1	嬌驕(~傲)交(又音，攙雜)僥
kiau2	喬（~裝打扮）僑蕎橋（~牌）
kiau3	餃（水~）角（水~）繳攪（~亂）九（又音，跋~：賭博)矯
kiau4	□（~中哥：以中指侮辱人)
kiau5	叫（大呼小~）轎
kʰiau1	蹺（~骹：蹺腿)
kʰiau2	喬（又音，~儂：纏著人)
kʰiau3	巧（又音，機~）
kʰiau5	翹（~尾：翹尾巴)竅（~門）
giau2	堯蟯
giau4	撟（撬也）
hiau1	囂（喧~）梟（~雄）僥（~幸ʰ驍（~勇）枵（~腹從公）
hiau2	嬈（女人不正經，舉止輕浮）hiau3	曉
iau1	夭（~折）妖枵（肚子餓）要（~求）腰邀
iau2	搖謠（歌~）瑤（琮~）窯徭（~役）遙（逍~）鷂颻姚（姓）
iau3	夭（又音，~壽）窈（~窕）
iau5	要（又音,重~）耀（榮~）鷂（又音）

m
2	媒（~儂：媒人)梅（楊~）
3	姆（又音，伯母）
5	呣(不，不要)

im
tim2	沈（~沒）
tim4	朕（皇帝自稱）
tim5	揕（掂也）鴆（~酒）㶩（~雞：燉	雞)
tʰim1	琛
tʰim5	沈（又音，投水）
lim1	啉（~水：欱水)
lim2	林（姓）淋琳（~瑯滿目）霖（甘~）臨（~別）
lim	凜（~冽）廩忍（~耐）
lim5	任賃（租~）妊（~婦）刃韌（~帶）吝
tsim1	斟（吻也）
tsim2	蟳（一種海蟹）潯（~尾：地名)
tsim3	嬸枕（~頭）
tsim5	浸
tsʰim1	侵（~略）深
tsʰim3	寢（~室）
tsʰim5	沁（~園春 詞牌名)
sim1	心芯（燈~）
sim2	尋潯
sim3	審嬸瀋（~陽）
sim4	甚（~至）
sim5	滲（~透）
kim1	金今（~日）
kim3	錦
kim4	妗（舅母）
kim5	禁
kʰim1	欽（~差）
kim2	琴黔禽擒
gim2	吟（~詩）
gim3	[錦]（量詞，局）
him1	欣
him2	熊
him5	□（猛砸）
im1	音陰（~謀）蔭（~蔽）淹
im2	淫（~威）霪（~雨）
im3	飲（~食）
im5	蔭（又音，戴~：蔭庇)

am
tam1	耽（~誤）眈（虎視~~）擔（~保）
tam2	談淫（濕也）澹（濕也）
tam3	膽（~識）
tam4	湛（精~）
tam5	覘（~頭：低頭，點頭)啖（~糝：喫點東西)淡（~水）氮
tʰam1	貪
tʰam2	痰覃潭譚曇（~花）罈
tʰam5	探（~親）
lamt1	襤（以物炫燿）
lam2	南楠男婪（貪~）藍淋（~雨）
lam3	覽（展~）攬纜荏（不結實）
lam5	濫（泛~）艦（軍~）
tsam1	針霑（~染）簪（~花）
tSam3	斬嶄（~然)
tsam1	站（車~）斬（又音，剁）暫
tsam5	蘸
tsʰam1	參（倉含切，~加）摻（~水）
tsʰam2	蠶
tsʰam3	慘
tsʰam5	懺（~悔）讖（預言 ）
sam1	衫杉（雲~）三參舢（~板）
Sam	糝（濫~：隨便，亂來)
sam	鬖（毛髮散亂）
kam1	甘柑泔疳坩（~鍋）
kam	2	含（~糖）
kam3	感敢（勇~）□（蓋上）
kam5	監（~工）鑑（~定）
kʰam1	戡（~亂）堪龕（佛~）
kʰam3	砍坎侃鬫（神氣，自大）
kʰam4	喊（~嗽：咳嗽)
kʰam5	勘（~蓋 蓋上蓋子)
gam2	癌巖
ham1	蚶憨
ham	2	含（包~）晗函（涵~洞）銜（軍	~）咸（~陽）邯（~鄲 地名)
ham4	喊撼（~動）頜
ham5	泛（~~：隨便，將就)陷（衝鋒~陣）憾（遺~）
am1	庵闇（癡也）
am2	𧌄（~蝶：蝦蟆)涵（~空：下水道)
am3	飲（米湯）罯
am4	頷（~胿：頸)
am5	揞暗

iam
tiam1	砧（菜~：案板)
tiam2	恬甜
tiam3	點
tiam	4	憺（~靜：文靜)
tiam5	店坫（~泉州：居住在泉州)
tʰiam1	添（~丁）
tʰiam3	忝（病誠~：病得很厲害)
tiam5	忝（又）掭（拋入水中）
liam1	踗（~手~骹：躡手躡腳)拈
liam2	粘廉（~潔）鐮（~刀）臨（~時）
liam3	染（傳~）冉斂
liam5	念捻（~斷：掐斷)
tsiam1	尖
tsiam2	 潛（~水艇） 
tsiam4	 漸
tsiam5	 占（~ト ~領）暫（~時）
tsʰiam1	纖殲釺籤（打箴）簽
tsʰiam2	橙□（動詞，刺也）
tsʰiam5	僭（~權：越權)
siam1	苫（偷偷池取出）
siami	暹（~邏)蟬嬋禪（~宗）
siam3	陝（~西)閃（~功）
siam5	滲（液體流出或漏出）
kiam1	兼
kiam2	鹹（~魚）
kiam3	鹻檢撿
kiam5	劍
kʰiam1	謙
kʰiam2	緘（林~）
kʰiam3	歉（道~）
kʰiam4	儉
kʰiam5	欠（~儂：欠人)歉（又音，~收）
giam2	嚴（~明）閻巖（~石）
giam3	儼（~然）
giam5	驗（實~）
hiam1	蘞（臭~~：臭烘烘)
hiam2	嫌
hiam4	險
hiam3	喊（又音,~伊一聲)
iam1	奄掩（~護）淹（~沒）醃閹
iam2	鹽（食~）
iam3	掩（又音，~護）
iam5	厭（討~）炎焰豔（~麗）

əm
tsəm1	箴（~對）針=
tsam3	怎=
tsʰəm1	參（楚簪切，~差不齊）
səm1	森（~林）薓
həm1	欣（又音，~~向榮）

in
pin1	賓檳繽濱彬扁-（~擔）瀕
pin2	貧頻屏憑
pin3	稟匾=
pin5	鬢(~髮)擯(~棄)殯臏
pin1	乒
pʰin2	□(燒酒啉仔~~:酒喝得醉醺醺)
pin3	品
bin2	民眠岷閩=
bin3	敏(~銳)閔(姓)憫(憐~)抿
bin5	面-(-洗~:洗臉	)
tin1	珍=津(天~)
tin2	塵=(~世)藤-陳=(~皮)
tin3	振(~動:搖動)
tin5	鎮陣=(~地)
tʰin1	□（微~通：稀溜溜)
tʰin2	縢（~水：倒水)
tʰin5	媵-（~頭：配對兒)趁=
lin1	奶-（橡~：橡膠)
lin2	鄰憐燐(~火)轔(麒~)磷鱗=(~片)人(~民)仁
lin3	恁(你們)
lin5	輾-(旋轉)韌=(又音)認(~識	)
tsin1	真(~假)瞋升-(量詞:一~)甄(~別)
tsin2	秦繩-(凝視	)
tsin3	震(地~)振=(~興)賑(~濟:救濟)診(~所)疹(麻~)拯(~救)
tsin4	盡(~力)
tsin5	晉搢=燼(灰~)進
tsʰin1	親=
tsʰin5	秤-稱-凊-(秋~:涼快)
sin1	新薪身申伸
sin2	神辰(星~)晨承-(從下接物)臣(大~)繩-(又，~之以法)蠅-(胡~:蒼蠅)乘(食陵切，~勢)
sin3	鋅
sin5	信汛(防~)訊迅慎(謹~)剩	(~餘)腎=(=~臟)
kin1	今-(-~仔日:今天)
kin3	緊謹(~慎)僅
kin5	絹
kʰin1	輕(~重	)
kʰin3	肯-(呣~:不肯)汱(淺也)
gin2	-凝-(瞪眼或斜視)
hin2	呟-(~頭:頭暈)雄-(~黃)
in1	因姻茵(綠艸如~)銦(他們)絪(~線:繞線)
in2	寅
in3	引尹
in5	印孕應-(~答:答應)

un
pun1	分-(~開)
pun2	㖹(~火:吹火)
pun3	本=苯
pun4	笨
pun5	糞=畚(~箕	)
pʰun1	潘-(~:泔水)奔
pʰun2	盆
pʰun3	畚(又音，雞~沙:雞把沙撥開)
pʰun5	噴
bun1	[吻](笑~~:笑吟吟)
bun2	文(~章)汶雯(晴~:人名)門=(大前~:香煙的牌名)聞捫(~心自問)們(人~)
bun3	吻刎(自~)
bun5	悶問=(學~)
tun1	敦墩蹲噸鈍
tun2	脣
tun3	囤(~積)盾
tun1	沌(混~)鈍(遲~)
tun5	燉(~飯:文火烤飯)頓=通
tʰun1	吞
tʰun2	豚(豬~:正在生長的小豬)屯塵-(-煙~:塵土煙灰)
tʰun3	蠢-(愚~)
tʰun5	墊-(~海)
lun1	圇(~頭:伸頭)
lun2	侖(~巴)倫(人~)淪=(=~落)輪(車~)崙(崑~:山名)掄
lun3	忍-(吞~:忍耐)碾-暖-(~鍋:火鍋)
lun5	閨(~月)潤論嫩韌-(~皮:執拗而賴皮)
tsun1	尊遵樽(金~)諄(~~教導)
tsun2	船存前-(~年)
tsun3	準
tsun4	捘(絞也)
tsun5	圳(水~:水渠)俊(~傑)顫(發抖)陳陣(時~:時候)
tsʰun1	舂椿樹也倥~直村=山~
tsʰun4	存又音，尊~(尊重)
tsʰun3	蠢=(~材)
tsʰun4	偆(剩餘，~錢)
tsʰun5	寸
sun1	孫
sun2	旬(上~)詢(~問)巡純醇
sun3	筍(竹~)荀(~子)榫(接~)吮=
sun5	舜遜(謙~)順殉(~葬品)
kun1	軍君跟根巾斤筋
kun4	羣裙𤉙(用火煮物)拳-(~頭)
kun3	袞滾滾輥
kun4	窘(~態)近
kun5	棍郡
kʰun1	坤(乾~)昆崑琨鵾鯤堃髡(~喙鬚:刮鬍子)
kʰun4	蜷(盤卷)勤芹
kʰun3	菌(細~)捆墾懇
kʰun5	困睏
gun2	銀
gun3	□(我們;我)
hun1	昏=婚分=芬吩=(~咐)汾棻氛勳(功~)葷熏(~陶，~艸:煙艸)薰(香煙)
hun2	雲-痕紋墳魂焚渾諢
hun3	粉很狠(~食:拼命喫)
hun5	訓馴奮糞=憤恨=忿份混
un1	溫瘟恩殷冤(~屈)醞
un2	勻(均~)雲=(=四界~:到處遊逛)
un3	穩隱允𤸫(~痀:駝背)尹
un5	蚓揾醮也韞運韻暈=

an
pan1	班斑癍扳頒
pan2	瓶-(~仔:瓶子)
pan3	版板舨阪阪扳(又音，~手)
pan5	扮(~演)辦瓣範-(~聲:樣子)
pʰan1	攀
pʰan5	盼判=
ban	蠻閩-
ban3	挽-(~艸:拔艸)
ban5	曼慢幔漫謾熳饅蔓萬
tan1	1	丹單=鄲[噸](一~)
tan	彈=(手榴)~亭-(-~仔：亭子)陳-	(姓)檀(~板)聵(~雷：響雷)
tan3	等-(~一下)
tan5	旦(元~)但(~是)蛋（壞~）憚(肆無忌~)釘-訂-盯-誕
tʰan1	灘=灘=(他干切)癱=蟶(~乾)
tʰan1	坦=(=~白)袒(~護)疸=音挺-(~橫:橫著)
tʰan5	歎炭=碳=趁=(~早)澶=
lan1	跉-(手~:手繭)
lan2	蘭攔欄闌(夜~)瀾=(波~)難	(困~)鱗-(魚~)鈴-零-(~星)
lan3	□（我們）攤(《集韻》乃坦切)
lan4	卵-(男陰)
lan5	爛=(~漫)難(災~)
tsan1	曾-(姓)
tsan1	殘(~酷)層-(一~)殘（~豬：閹豬)
tsan3	盞=拃=
tsan5	贊讚=站（~隊）
tsʰan1	餐呻-（呻吟）
tsʰan2	塍-（田也）[田]纏=潺
tsʰan3	鏟=（~除）
tsʰan5	燦（~爛）
san1	珊（~瑚）刪山=星-（零~）
san3	產=（生~）㾪-（瘦）散=（蘇旱切）
san5	散（蘇旰切，~文）疝（~氣）
kan1	姦奸杆=竿=矸（油~：油瓶)	乾=（古寒切，~濕）間=閒=（古閑切，中~）艱（~苦）肝=
kan2	□（角 角銀之合音）
kan3	柬（~帖：請帖)揀簡（~化）𡢃（女婢）趕=（~馬上任）
kan5	幹（~部）間閒（古莧切，反~計）澗稈
kan1	刊牽（~牛）
kʰan3	侃
kʰan5	看
gan2	顏嚴-（冷也）
gan3	眼=（千里~）
gan5	雁彥-諺-唁-岸=
han1	番-（~薯：甘薯)
han	2	邗韓閒閑寒
han3	罕（~見）[喊]（大~大叫）
han4	限㢨=
han5	漢汗翰瀚旱（乾～）焊捍（~衛）
an1	安=鞍=（馬~）氨
an2	恒-（緊也）
an5	案桉=（~樹）按

ian
pian1	邊=鞭=編（~輯）
pian	緶（~仔：紡織品一類的花	邊)
pian3	扁=（~食）匾=蝙（~蝠）貶（~值）
pian4	辨辯辮=
pian5	變=（~化）駢卞汴便(方~	)
pʰian1	偏=（~向）篇=(=名~)翩(~~起舞)
pʰian2	蹁(不正)
pʰian3	要這要那
pʰian5	騙片(~面)遍(一~	)
bian2	棉=綿=眠=
bian3	免勉娩冕緬
bian5	面=
tian1	顛癲滇(都年切，~池)巔
tian1	填(~充)田
tian3	展(~覽)典碘
tian5	電佃(租~)甸(緬~:國名)	殿奠滇=
tʰian1	天(~~向上)
tʰian3	展(又音，~開)腆(~腹肚)
lian1	蔫(枯萎)
lian	連=蓮=璉漣鰱年=(青~)聯憐=然=燃=(~料)
lian3	碾=(石~)輦(力展切，步~)撚=(紙~:紙引)
lian5	煉練鏈荔=(~枝	)
tsian1	煎=(~熬)箋淺(《集韻》將先切，~~流水)
tsian2	前=(~進)錢=
tsian3	剪翦譾=(~陋)
tsiany戰(~士)箭=(~步)薦=(推~)顫=賤餞煎(蜜~)濺=踐
tsʰian1	千=遷阡(~陌)
tsʰian2	延-(~工:花工夫)
tsʰian3	淺=(七演切，水~)鏟=(鐵~)
tsʰian5	茜倩(~影)
sian1	先=(~生)仙秈鮮=(~血)躚(翩~)
sian2	涎
sian3	癬=鮮(息淺切,新~)鋅(又音)	筅=
sian4	善鱔(魚~)僐(疲倦)羨(欣~:羡慕)
sian5	扇=搧(用巴掌打人)煽線=繕(修~)膳(用~)單(姓)嬗(~變)腎-(~子:睾丸)
kian1	堅肩=(~負)
kian2	乾(~坤)
kian3	繭囝=
kian4	件=胘=(雞~:雞胃)
kian5	建健=(~康)腱毽見(~識	)
kian1	騫牽(門~:釕銱兒)
kʰian2	虔(~誠)
kʰian3	犬遣譴
kʰian5	健-(勇~~:很健康)□(量	詞:回，次。)
gian2	言凝-(目珠~~:眼神嬯滯)
gian3	硏=
gian5	慭(喜好)彥=諺=唁=
hian1	掀軒
hian	2	玄弦=舷=眩=胘=懸=(~殊)賢
hian3	顯炫
hian4	莧=
hian	5	獻=憲現𦜓(羊~:羊的臊味)衒=
ian1	煙胭咽(~喉)焉嫣(~然一笑)淵
ian2	沿鉛延=筵蜒涎緣簷=
ian3	演偃(相~：摔跤)衍(敷~)
ian5	宴晏=堰燕=

uan
puan1	般=搬=	=
puan5	半=拌=
pʰuan1	藩=潘=
pʰuan2	盤=(又音)
pʰuan4	伴=
pʰuan5	叛=判=
buan2	瞞=
buan3	滿=挽=(~救)晚=(~會)
tuan1	端=
tuan2	傳=(直孿切，~達)
tuan3	短(~缺)
tuan4	斷=(~絕)
tuan	段=緞鍛煆傳(《集韻》柱	戀切，~記)
tʰuant	湍(~流)
tʰuan2	團=(~結)
tʰuan5	篆鍛(又音)
luan	2	戀巒孿攣鑾鸞灤
luan3	軟=(細~)暖=卵=
luan1	亂
tsuan1	專磚=顓
tsuan2	全=(~體)泉=(~州)
tsuan3	轉=(~送)賺
tsuan1	撰(編~)
tsuan1	鑽=
tsʰuan1	川=穿=村-邨-(農~)
tsʰuan1	攢(~儂:作弄人)
tsʰuan3	喘=
tsʰuan5	串=穿=竄=纂篡
suant	宣喧諠栓=拴=酸=(硫~)
suan2	旋=(~轉)鏇=漩璿
suan3	選
suan5	算(~術)蒜(裝~)鏇-鑽(~石)
kuan1	觀=冠(衣~)關=鰥官=棺=捐娟=鵑
kuan2	權顴(~骨)
kuan3	管=館卷=(《集韻》古轉切，~縮)捲=
kuan5	貫=慣=灌罐盥券眷倦卷=(居倦切，~宗)
kʰuant	寬=圈=(手~:手鐲)
kʰuan2	環-(耳~)寰-[圈](一~)
kʰuan3	款=(~待)
kʰuan5	勸=(~學)
guan1	原源元員
guan3	□（我等合）
guan1	原願
huan1	歡=(~迎)番=(~仔:洋人)翻幡吩-(~咐)
huan2	煩還(~原)環=(~行)寰=凡礬帆=樊桓繁
huan3	反返
huan4	緩=犯範=（模~）
huan5	販=飯=(~桶)喚煥瘓渙(~散)幻豢(~養)泛=(~論)患宦梵
uan1	彎=(~曲)灣(海~)冤=(~枉)鴛(~鴦)援(支~)
uan2	完莞丸=紈灣(臺~)員(又音)園=(~林)援(~用)袁(姓)
uan3	宛苑碗=剜豌腕=皖遠=頑玩
uan4	緩(推遲）
uan5	怨院=

ŋ
pŋ1	楓-(~樹)方-(姓)崩=幫-(依附;增補)
pŋ2	朋=
pŋ3	本(~錢)
pŋ4	傍(~福氣:霑光)
pŋ5	飯
pʰŋ1	烹砰=抨=
pʰŋ2	膨=(~脹)
pʰŋ5	嘭(惡~~:惡狠狠)
bŋ1	毛-(茅艸)
bŋ2	門-(大~)毛-(又音，雞~)
bŋ3	晚-(~釉:晚稻)
bŋ5	問-
tn1	當-(~兵)
tg2	長-(直良切,又音,久~:長久)堂-腸-唐-(~山:指中國)傳-(直攣切,錢~儂：給人家錢)騰
tŋ3	轉-等=(~級)
tŋ1	丈-盪-(洗~:洗滌)斷-
tŋ5	撞-(遇也)當-(又音，典~)頓(~骹:頓腳)
tʰŋ1	湯-(雞~)
tʰŋ2	糖-(白~)謄(~寫)騰(又音，飛~)
tʰŋ4	杖-(孝~:哭喪棒)
tʰŋ5	燙-(~金)褪-(~衫:脫衣)
lŋ1	□(口感滑溜)
lŋ2	瓤-郎-(牛~)榔-(檳~)芋能
lŋ3	軟-
lŋ4	卵-(又音，雞~:雞蛋)兩-(數詞）
lŋ5	淪-(鑽也)釀=(米~:米酒)
tsŋ1	裝-妝-(嫁~)莊-(農~)磚-曾=(~孫)增憎僧-爭=睜掙猙箏
tsŋ2	嘗-(蒼蠅霑物)曾(昨樓切，~經)層=全-從-(~古:從來)
tsŋ3	拃-(~甲:指甲)
tsŋ4	吮-(舔也)
tsŋ5	鑽-(~洞)狀-(告~)増(又音)憎(又	音)
tsʰŋ1	倉-(~庫)瘡-滄-艙-穿-川-(尻~:屁股)伸(又音，~手)村-(-又音，農~)創-(-刀~)
tsʰŋ2	牀-
tsʰŋ3	吮-(~骨頭:齩食骨頭)
tsʰŋ5	穿-(~珠)竄-(亂~)
sŋ1	霜-孀-酸-拴-栓-痠-(-骰~手軟:手腳無力)生=(=學~)甥(外~)桑-(-~樹)僧
sŋ2	牀-(又音，籠~:蒸籠)
sŋ3	損-(-~神:損害精神)
sŋ5	算-(-~數:算賬)蒜-
kŋ1	缸-扛-光-更=庚=羹=耕
kŋ3	廣-~州(地名)卷-(《集韻》古轉切，花~)捲-管-(-竹~)哽=梗=
kŋ5	鋼-杠-(-單~)卷-(-居倦切，考~)
kʰŋ1	康-糠-坑=(=~害)圈-（畫圈）
kʰŋ3	肯=(~定)
kʰŋ5	勸-(~告)囥-亢-(藏也)
hŋ1	荒(開~)昏(下~:晚上)方-(又音，地~)亨哼
hŋ2	園(公~)
hŋ4	遠-哼(應管聲)
hŋ5	哼(嘆詞,表示鄙視)
ŋ1	央-(中~:在中閒)秧-(~苗)
ŋ2	黃-(~色)磺-(硫~)
ŋ3	影-(樹~)䘼-(手~:袖子)
ŋ5	映(~望:希望)暈(光圈)


iŋ
piŋ1	冰兵=浜=繃=
piŋ2	朋(~友)平=(~反)瓶=(金~梅:書名)
piŋ3	丙=炳=餅=秉(~公辦事)
piŋ4	並(比~:比較)
piŋ5	並(~且)併(合~)姘迸=摒=柄=(把~)病=
pʰiŋ2	彭=澎=膨(~脹)硼鵬蘋=(~果)萍坪=評
pʰiŋ5	聘(~請)姘(~頭)碰拼=(~音)
bŋ2	明=(~白)盟萌名=(~目)銘冥=瞑鳴
biŋ3	孟猛錳蜢=
biŋ5	命=(~令)
tiŋ1	丁汀燈釘=疔町盯=登
tiŋ2	澄(~清)欄廷庭=霆(雷~萬鈞之力)重-(直容切，~寫)滕=藤=
tiŋ3	頂鼎=(~立)戥(匯~:天秤)等=(又音，三~五號:各色各樣)
tiŋ4	錠=
tiŋ5	鄧鄭=定=(一~)錠=(=又音)碇=訂=(制~)釘=(又音)盯=(又音)中(陟仲切,~意)鐙(馬~)
tʰiŋ1	廳=聽=(~命)汀(又音，長~:地名)
tʰiŋ2	呈=(~送)程=(日~)亭=停婷騰(又音)
tʰiŋ3	挺=鋌艇騁(馳~)
tʰiŋ5	聽=(又音，~候:等候)牚=
liŋ1	蘢-(青~~:很青)
liŋ2	靈櫺欞鈴=玲伶苓羚翎齡聆蛉囹淩陵絞菱棱零=龍-寧
liŋ3	冷嶺=領=(~導)
liŋ4	□條狀傷痕
liŋ5	宂-(鬆也)另零令
tsiŋ1	貞禎偵楨舂-(~米)摏(拳打)漳-(~州:地名)晶=(結~)睛(眼~)精=(~神)蒸-鐘(~表)正=征懲(~罰)牲-(-~~:牲畜)盅(茶~:小茶盅)
tsiŋ2	情=(~義)晴榕-松-
tsiŋ3	整腫-種-(之隴切,黃~)井(市~)
tsiŋ4	靜=
tsiŋ5	正=(之盛切)政證症眾-(~儂:眾人)種(之用切，種植也)諍=(~友)
tsiŋ1	青=清=蜻(~蜓)稱(~呼)千-
tsʰiŋ3	請=(申~)
tsʰiŋ5	銃-(槍也)沖-(~飯:燜飯)稱(又音，對~)凊頌-(穿也)
siŋ1	升=聲=(~明)星=(明~)腥=牲=(~口)傷(又音，~風)
siŋ1	成=誠=城=(價值連~)丞承=繩=乘(食陵切，又音,~除)
siŋ3	省㾪=醒=(~悟)
siŋ4	恿=(溺愛、嬌縱)
siŋ5	勝性姓=(~名)聖=盛乘(實證切，車乘)
kiŋ1	經=耕(又音，~牛)弓-宮-(~仔:小廟)荊=供(口~)京=驚=鯨
kig1	窮-(~儂:窮人)
kiŋ3	景憬拱-龔-(姓)
kiŋ5	敬儆警竟鏡=兢競勁徑(直~)脛頸痙
kʰiŋ1	卿筐-框-氫輕=傾(~向)芎-(~蕉:香蕉)
kʰiŋ2	瓊-(~樓)窮-(又音,~數:算賬)
kʰiŋ3	頃
kʰiŋ4	共-彩虹[虹]彩虹
kʰiŋ5	慶罄(~竹難書)
giŋ1	鉠(鈴聲)
giŋ2	迎=凝=(~固)
giŋ4	硬=
hiŋ1	興(~旺)胸(雞~)兄
hiŋ2	刑形邢型行=(~為)雄-(又音，卵有~:蛋有胚胎)滎(~陽:地名)恒=(~星)橫=弘-(~一法師)
hiŋ4	杏(~林:地名)
hiŋ5	興(許應切，高~)行(下更切，品~)幸
iŋ1	英瑛膺鷹鶯鸚(~鵡)嬰=櫻纓=癰-應=(~該)雍-(姓)
iŋ2	榮(光~)紫螢熒(~光屏)瑩營=(~救)瀛盈=蠅=(~頭小利)
iŋ3	永-(~春:地名)泳詠(~歎)穎影=(~響)涌-(上~:地名)
iŋ5	應=(又音，~允:答應)映=(反~	)用-(~儂:用人)媵=


aŋ
paŋ1	方-(又音，四~:四四方方)枋-(木板)封-(量詞:一~批:一封信)邦幫-(又音)崩-(山~地裂)浜-
paŋ2	房-龐(姓)馮-(姓)逢-(幸~)
paŋ3	綁(~票)
paŋ4	蚌
paŋ5	放-(~假)棒
pʰaŋ1	峰-(~尾:地名)蠭-蜂-(蜜~)芳(香也)
pʰaŋ2	帆-篷-捧-龐(又音，龐大)
pʰaŋ3	紡-(~織)
pʰaŋ5	肨=縫-(扶用切，裂~)
baŋ1	濛-(雨~仔:牛毛細雨)
baŋ2	芒-茫-忙-氓
baŋ3	蠓-(蚊子)蟒-
baŋ4	網-
baŋ5	夢-望-
taŋ1	冬-東-當-(又音)噹鐺
taŋ2	同-(~安:地名)銅-筒-(骹~:大腿)童-僮-(跳~:跳神)幢(南~:地名)
taŋ3	董-(校~)
taŋ4	動-(活~)重-(直隴切，輕~)
taŋ5	凍-(~手)棟-洞-
tʰaŋ1	窗-通-(光~:亮堂)通(可以)
tʰaŋ2	蟲-桐-(~油)
tʰaŋ3	桶-統-(鞋~)
tʰaŋ5	痛-(忝~:疼愛)
1	aŋ1	朗(疏~:稀琉)[朗](巴~魚:一種食用魚)
1	aŋ2	聾-(臭~:耳聾)礱-(塗~:礱穀的農具)膿-(流~)儂-(人也)[人](人也)
laŋ3	籠-(竹~)攏-(~褲:提褲子)
laŋ4	籠-(又音 箸~:放筷子的器具)
laŋ5	弄-(戲弄)
tsaŋ1	棕-鬃-(馬~)髒-	-
tsaŋ2	叢-(量詞:一~)沖-(~水)
tsaŋ3	𥡥-(菜~尾:蘿蔔的枝葉)總-(無頭~:沒有頭緒)
tsaŋ4	□(揪頭髮）
tsaŋ5	糉-粽-
tsʰaŋ1	匆-蔥-蒼-聰-
tsʰaŋ3	傯(茹~~:十分淩亂)
tsʰaŋ5	倡-(~頭:愛出風頭)[聳](頭毛~起來:頭髮豎起來)
saŋ1	鬆-(輕~)雙(量詞,一~箸:一雙筷子)
saŋ2	□(相同)
saŋ3	搡-(推也)
saŋ5	送-
kaŋ1	工-(~廠)江肛(~門)公-(豬~:種
豬)蚣-(蜈~)剛-崗-綱-
kaŋ3	講港犅(牛~:公牛)
kaŋ5	降(古巷切，下~)共-(又音，相	~:互相幫助)
kʰaŋ1	空-(~城計)腔=(喙~:口腔)康-(-又音，有~:富裕)
kʰaŋ3	孔-(面~:臉孔)
kʰaŋ5	控-(~鼻屎:挖亁的鼻涕)
haŋ1	夯-烘-(~手:烤手)
haŋ2	杭-航-行-(胡郎切，~列)絎(~線）降（下江切，投~）
haŋ3	哄(~儂:嚇唬人)
haŋ4	項
haŋ5	放-(又音，發炎腫大)巷
aŋ1	翁-(丈夫)肮-(~髒	)
aŋ2	紅-(~紙)洪-(姓)
aŋ5	甕-(米~	)

iaŋ
piaŋ1	砰-
piaŋ4	龐(又音，大~:大箇子)
piaŋ	5	迸-(硬~~:生硬)
pʰiaŋ2	-蘋-(~果)
pʰiaŋ3	□(以物顯耀)
pʰiaŋ5	迸-(又音，裂開)
liaŋ2	涼=(~粉)
liaŋ5	亮-
tsʰiaŋl槍=(~林彈雨)鏘(鏗~有力)
tsʰiaŋ2	□-(~~滾:鼎沸)腸=(臘~:香腸)橙-(又音)
tsʰiaŋ3	蹌-(獨腳行走)
tsʰiaŋ5	唱(事先講清楚)
siaŋ2	□(誰)
siaŋ5	□(倒下)
kiaŋ1	僵-(~局	)
kiaŋ5	𠣃	(有本事)
ŋiaŋ1	(	鉚~~仔:搖鈴)
ŋiaŋ5	齴-(牙齒外突)
hiaŋ1	鄉=
hiaŋ3	響=餉=(發~:發薪)
iaŋ4	漾-(在水中涮洗)

uaŋ
huaŋ1	風(吹~)
uaŋ4	□(閒逛閒聊)

ɔŋ
pɔŋ1	幫=
pɔŋ2	旁膀(~胱)螃磅(~礴)彷(~徨)房-(又音，洞~)
paŋ3	榜=(標~)
pɔŋ4	磅(又音，~稱)傍=
pɔŋ5	嗙(誇大、吹牛)謗(誹~)
pʰɔŋ1	乓(乒~毬)滂(~湃)
pʰɔŋ2	蓬(~勃)房-(又音，量詞，整套傢俱)棚=
pʰɔŋ3	捧-(又音)
pʰɔŋ4	[膨](~母:本錢)
pʰɔŋ5	碰-(~杯)肨(~起來:膨脹起來)
bɔŋ1	摸-
bɔŋ2	亡(~國)芒=(~種)茫=盲=(文~)蒙朦濛=檬(檸~)
bɔŋ3	莽蟒懵=(~懂)網=(法~)蠓=
bɔŋ5	夢=(~想)妄(癡心~想)忘(~年之交)望=(威~)
tɔŋ1	東=當=(=臨~時:臨時)冬咚
tɔŋ2	同=(共~)桐=(梧~)銅=筒=唐=塘=	=堂=膛童=潼朣僮=幢(又音，~幡)棠
tɔŋ3	黨董=(~事)懂
tɔŋ4	動=
tɔŋ5	棟=凍(~結)檔擋=撞=(~針)洞=恫(~嚇)侗(~族)蕩=
tʰɔŋ1	通=(~知)嗵=
tʰɔŋ3	統=(~一)桶=捅
tʰɔŋ4	□(~𠼱~𠼱:得過且過)
tʰɔŋ5	痛=(~苦)
lɔŋ1	啷
lɔŋ2	農濃儂=膿=隆郎=廊(走~)螂=榔=琅狼瓏(四面玲~)
lɔŋ3	朗(~誦)攏=(拉~)隴籠=(~罩)壟(~斷)
lɔŋ1	[哢](使~:挑撥唆使)
lɔŋ5	=弄=(里~)挵(~一空:撞一箇窟窿)浪(波~)
tsɔŋ1	宗淙綜蹤棕=鬃=莊=妝=裝=(武~)
tsɔŋ2	崇叢=(~書)𧺣(亂~:四處活功奔走)
tsɔŋ3	總=
tsɔŋ5	葬壯(勇~:壯實)狀=(現~)奘(唐三~:唐僧)藏(西~)臟(肝~)
tsʰɔŋ1	聰=倉=蒼(又音)滄=傖=艙=瘡=匆=蔥=
tsʰɔŋ2	叢=(又音，~雜)牀=	=
tsʰɔŋ5	創(初亮切，~辦)
sɔŋ1	鬆=(~耎)喪=雙=霜=孀=
sɔŋ2	庸-(土裏土氣)
sɔŋ3	爽(~直)搡=
sɔŋ5	宋送=頌=
kɔŋ	公=(~平)蚣=光=(~明)工=(~作)缸=岡綱=剛=崗=
kɔŋ2	狂(瘋~)
kɔŋ3	廣=(~場)
kɔŋ5	貢杠=(~杆)摃(擲也)
kʰɔŋ1	空=(~氣)腔=(又音)康=(~健:健康)匡(~正)筺=筐=框=
kʰɔŋ2	窮-(又音:盤點、清理)
kʰɔŋ3	孔=慷
kʰɔŋ5	□(~~顛:七顛八倒)
kʰɔŋ5	礦曠(~課)抗(抵~)控=(~制	)
ɡɔŋ2	昂
ɡɔŋ5	戇(傻也)
hɔŋ1	峰=蜂=鋒烽荒=謊=慌方=(~向)芳=(芬~)肪(脂~)風=(~水)楓=諷豐轟封=
hɔŋ2	紅=虹鴻馮=逢=縫=防房=弘=宏洪=(~水)皇=惶蝗煌徨=黃(雄~)癀(發~:發炎腫大)簧(彈~)杭=航=捧=行=(胡郎切)
hɔŋ3	況晃幌恍仿紡=訪汞
hɔŋ4	奉
hɔŋ5	放=(~生)俸鳳
ɔŋ1	翁=(=主人~)嗡汪(姓)王
ɔŋ3	枉往=(=無~不勝)
ɔŋ5	旺(~梨)

iɔŋ
tiɔŋ1	中(陟弓切，居~)忠張=
tiɔŋ2	腸=(又音)場=重=(直容切，~複)長(直良切，~久)[𩞉]饞也
tiɔŋ3	長=(知丈切，生~)
tiɔŋ4	丈=(~夫)仗杖=重=(直隴切,~要)
tiɔŋ5	長=(直亮切，多也)漲=(高~)脹=中=(陟仲切，射~)
tʰiɔŋ衷(苦~)
tʰiɔŋ2	蟲=(蝗~)
tʰiɔŋ3	寵=(~愛)塚(公~:公墓)
tʰiɔŋ4	丈=(又音)
tʰiɔŋ5	暢
liɔŋ2	良糧=(五~液:酒名)娘=量=(呂張切，測~)涼=(又音)絨茸瓤=龍=粱=(高~)梁=(棟~)
liɔŋ3	兩=(三三~~)輛=嚷壤(土~)
liɔŋ5	量=(力讓切，力~)亮=諒讓=釀=
tsiɔŋ1	章=(~程)漳=障(保~)鄣獐=樟=蟑璋彰將(卽良切，~來)終盅=鍾=(~情)
tsiɔŋ2	從(服~)崇(又音，~武：地名）
tsiɔŋ3	種=(之隴切，種類也)掌獎
tsiɔŋ5	將(子亮切，大~)眾=(羣~)種=(之用切，種植也)狀-(又音 狀元)
tsʰiɔŋ1	充衝(~鋒)昌倡娼猖槍=(又音，~林彈雨)沖=(~洗)
tsʰiɔŋ2	薔=(~薇)牆=檣
tsʰiɔŋ3	 廠=蹌=
tsʰiɔŋ5	倡=(提~)唱=(提~ ~票)匠=縱
siɔŋ1	相=(息良切，相互)廂(西~記)湘箱=商嵩(~山:山名)傷=(~兵)襄(~陽:地名)鑲
siɔŋ2	祥詳翔松=(~香)常裳=瘍=(=齒~:牙垢)□(誰也)嘗=(嘗試)
siɔŋ3	賞=[嘗](~試)償
siɔŋ4	象=(~形)像=(畫~)橡=上=(時掌切,~山）
siɔŋ5	相=(息亮切，~貌)尚=(高~)頌=誦上=(時亮切，~級)
kiɔŋ1	恭供=(~應)噩躬宮=(~殿)薑=韁=僵=弓=芎=(川~)	
kiɔŋ2	強=窮=(無~無盡)瓊=
kiɔŋ3	拱=(相~:互謙)龔=
kiɔŋ5	共=(~同)
kʰiɔŋ1	姜=羌(~族)腔-
kʰiɔŋ2	瓊=(又音)
kʰiɔŋ3	鞏(~固)恐
ɡiɔŋ3	仰(~光:地名)
hiɔŋ1	凶洶匈胷=胸=鄉=(又音)香=
hiɔŋ2	雄(~關)熊(~羆)
hiɔŋ3	享響=（又音）
hiɔŋ5	向=(方~)餉=(派~)
iɔŋ1	央=(中~)殃泱秧=鞅雍=擁癰
i=ɔ=ŋ=2	=容=溶=熔=蓉=榕=羊=洋=烊=佯=徉=(=倘=~=)=揚=楊=瘍=(=潰=~=)=陽=融=庸=
iɔŋ3	養=癢=氧勇恿=湧=踴永=仰(又音，瞻~)
iɔŋ5	漾=(蕩~)恙(安然無~)用=傭(雇~)

ĩ
pĩ1	邊-鞭-繃-(~鼓:把鼓皮繃起來)
pĩ2	平-(~坦)坪-棚-(戲~)
pĩ3	扁-(圓~)
pĩ4	辮-(打辮子等)
pĩ5	柄-病-變-(~面:翻臉)
pʰĩ1	篇-偏-（~儂：欺負人)
pʰĩ2	彭-(姓)澎-
pʰĩ5	片-(量詞:一~)
bĩ	1	塓-(~沙:抓沙)
bĩ2	棉-綿-彌暝-(~時:晚上)盲-(青~:眼瞎)
bĩ5	麪-(~粉)
tĩ1	𩨑-(骹後~:腳後跟)珍-(甜)[甜]
tĩ2	纏-(~𣍐直:糾纏不休)
tĩ4	滇-(滿)
tĩ5	𩏠(~笑:強笑)鄭-
tʰĩ1	天-添-
tʰĩ5	牚-(頂也)䋎-(~衫:縫衣服)
lĩ1	奶-(又音，橡~:橡膠)
lĩ2	年-(今~)尼妮呢泥(水~)連-(黃~)
lĩ3	染-(~布)爾=耳=(木~)你
lĩ5	輦-(下~:地名)
tsĩ1	精-(妖~)爭-(相~)晶-(水~)
tsĩ2	錢-簷-(厝~:屋簷)
tsĩ3	井-譾-(幼小，不成熟）
tsĩ4	靜-(暗~:暗中，偷偷)
tsĩ5	煎-(~粿:煠的米粿)箭-諍-搢-(硬擠進人羣)
tsʰĩ1	青-星-(又音，星星)腥(臭~:腥味)生-淒-(~慘)鮮-(~釋?:新鮮)親-(~姆:親家母)
tsʰĩ2	□(耀眼;探身	)
tsʰĩ3	醒-淺-(~紅)
tsʰĩ4	箭-(又音，向前衝)
sĩ1	生-(又音，先~)
sĩ2	鹽-(橄欖~:醃製的橄欖)
sĩ5	姓(百~)扇鹽(又音,~菜:醃菜)
kĩ1	更-(一~)庚-羹-(肉~)經-(~布:織布)鹻-
kĩ2	舷-(邊~:邊沿)舷-(邊沿也	)
kĩ3	哽-(咽也)梗-(桔~:中藥名)
kĩ5	見(~面)
kʰĩ1	坑-(~溝:小河溝)
kʰĩ2	鉗-
gĩ4	硬-
hĩ5	獻(扔掉)硯
ĩ1	嬰-(~仔:嬰兒)
ĩ2	楹-(~仔:房梁)圓-丸-
ĩ5	燕-院-

ã̃̃
pã1	[叭]喇叭聲
pʰã1	□(火一下子燃燒起來)
pʰã5	泛-(又音，不結實)怕
bã1	哞-(放聲哭	)
bã2	母(母親)媽(母親)麻=(桑~)
bã3	馬=母(又音，祖母)媽(又音，祖母)碼
bã4	嘛(~是:也是)
bã5	罵
tã1	擔-(動詞)[今](今也)
tã2	譚-(重~:差錯)
tã3	打(~倒)膽-疸-(黃~)
tã4	淡-(鹹~:口重)
tã5	擔-(都濫切，名詞)訂-(~話:說話)誕-(說~:說錯)
tʰã1	他-(其~)它-(~們)
tʰã3	坦-(平~)挺-(又音，托也)
lã1	娜-(人名別字)
lã2	籃-(~毬)林-(樹~)巖-(又音,龍~ 地名)
lã3	娜-(又音)挪=哪=拿(捉~)若-(如;像)
lã4	若-(又音，如果;僅	)
lã5	那-
tsã3	斬-(半~:腰斬)嶄-(齊~:整齊)
tsã4	㨻-(舀取	)
tsã5	蘸-(~日:曬太陽)
tsʰã1	□(操辦;鬧一番	)
tsʰã4	㨻-(又音，~鑔:銅鈸)
sã1	三-叄-參-相-(息良切，~看:互相看)衫-(上衣)
sã2	□((狗等)猛撲)
kã	1	監-(~獄:牢獄)柑-
kã2	含-(又音，啊~:表驚奇的嘆詞)
kã3	敢-囝-(子女)[仔](子女)
kã5	酵-
kʰã1	坩-（陶罐）
kʰã2	銜-(挾著	)
gã3	雅(文~)
hã	2	焓-(~火:烤火)
hã	2	撖-(門~:門縫)
ã1	□(~~:喇叭)
ã2	涵-(偏袒)
ã3	罯-(挨近,偏向)[仔](又音，詞尾或詞嵌:鋸~:鋸子)
ã5	餡-揞-(彎下，低下)

iã
piã1	抨-(扔，摔)
piã2	平-(又音，~仄)
piã3	餅-丙-
piã5	拼-摒-(~水:倒水)
pʰiã1	𩩍-(~支骨:肋骨)
pʰiã2	坪-(又音，山~:山坡)
pʰiã3	丙-(又音，量詞，用於塊狀物)
biã2	名-(姓~)明-(清~)
biã5	命-(性~	)
tiã2	庭-(法~)呈-埕-(粟~:曬穀場)
tiã3	鼎-(大~:大鍋)
tiã4	錠-(紫金~)
tiã5	定-(停也)錠-(又音，一~)靛-
tʰiã1	廳-(大~)聽-(~話)
tʰiã2	呈-(又音)程-(姓)
tʰiã5	忝-(疼痛;疼愛	)
liã	2	娘-(母親	)
liã		嶺-
tsiã1	正-(~月)精-(~肉:瘦肉)
tsiã2	成-(~年:將近一年)誠-(~好	:很好)情-(親~:親戚)
tsiã3	𩟗-(也)
tsiã5	正-(之盛切，~本)
tsʰiã1	淸-(福~:地名)
tsʰiã2	成-(又音，~尾:收尾)

tsʰiã3	請-(~客)且(而~)
tsʰiã5	倩-(~儂:雇人)
siã1	聲-(~音)
siã2	成-(又音,幾~)城-(~池)啥-(什麼)
siã5	𣛮-(穀倉)聖-(靈驗)
kiã1	京-驚-
kiã2	行-(戶庚切，步趨也)
kiã4	件-(物~:東西)健-(又音)
kiã5	鏡-(目~:眼鏡)
kʰiã1	輕-(又音，~薄:身體虛弱)
kʰiã5	慶-(~賀)
giã2	迎-(~燈:燈會)
hiã1	兄-(~弟)
hiã2	燃-(~水:燒水)
hiã3	顯-(~目:顯眼)
hiã5	向-(搖晃)艾-(~條:艾絨)
iã1	纓-
iã2	營-(~級)螢-(火~:螢火蟲)嬴-盈-(大~:地名)
iã3	影(電~)
iã4	揚-(~扇:揮扇)
iã̃5	映-(又音，光~~:亮堂堂)

uã
puã1	般-搬-(~家)
puã2	盤-(~仔:小盤子)
puã3	阪-(蘇~:地名)
puã4	拌-(撲打)
puã5	半-拌-(又音,乾~麪:雜拌麪)絆-
pʰuã1	潘-(又音，姓)
pʰuã2	盤-(又音,~牆:翻牆)
pʰuã4	伴-(同~)
pʰuã5	判-(~決)販-(~貨:批發)
buã1	幔-(~衫:披衣)
buã2	瞞-麻-(~油)鰻-
buã3	滿-(~意)
tuã1	單-(清~)端-(無因致~:無事生非)
tuã2	彈-(~琴)壇-(文~)
tuã3	[𫢸](~~:總是)
tuã4	憚-(貧~:懶惰)彈-(又音，心跳)
tuã5	旦-(戲~:旦腳)段-(手~)
tʰuã1	攤-(他下切，~牌)灘-(海~)
tʰuã3	㔊-(~艸:鋤艸)
tʰuã5	炭-(火~)碳-澶-(繁殖)
luã2	欄-(分~)攔-
luã3	攤-(《集韻»,乃坦切,~麪:揉麪)
luã4	瀾-(唾液	)
luã5	懶-(行動緩慢)爛-(~心)
tsuã1	煎-(~藥)
tsuã2	泉-(~水)
tsuã3	盞-(一~燈)
tsuã4	濺-(~水:噴水)
tsuã5	饡-(~油:熬油)
tsʰuã1	䉔-(柴~：木刺)
tsʰuã2	□(~艸:拔艸)
tsʰuã3	癬-(狗~:一種皮癬)
tsʰuã5	[閂](~門:插上門)
suã1	山-
suã3	散-(蘇旱切,藥~)產-(房~)
suã5	散-(蘇旰切，鬆~)傘-(雨~)線-(紡~)
kuã1	肝-(心~)杆-竿-官-(軍~)棺-(~材)倌-菅-(一種艸)娟-乾-
kuã2	寒-
kuã3	趕-
kuã4	㢨-(~水:提水)
kuã5	觀-(白~:名)汗-(流~)
kʰuã1	寬-(急事~辦:急事緩辦)
kʰuã3	款-(貨~)
kʰuã5	看-
huã1	歡-
huã2	鼾-(打鼾)
huã3	緩-(又音，一~過三冬:形容情一拖就好長時間)罕-(~~:模糊)
huã5	岸-(海~)捍-(~家:持家)焊-
uã1	安-(南~:地名)旱-(苦~:旱災)
uã3	碗-腕-
uã5	晏-(晚也)換-案-(香~)

ɔ̃
bɔ̃1	[虻]（牛~）摸-(又音)
bɔ̃	2	毛=(~筆)魔摩磨=(莫婆切)模(又音)
bɔ̃5	冒帽=磨=(橫臥切)戊(又音)
1	ɔ̃2	挪(~用)
1	ɔ̃3	老=(~師)魯
lɔ̃4	懦(懶散、拖拉)
1	ɔ̃5	怒那-
kʰɔ̃3	考拷(~打)烤(~鴨)可=
gɔ̃2	吾(又音)梧(又音)譌鵝娥俄蛾吳(又音)
gɔ̃3	我=
gɔ̃5	傲捂臥
hɔ̃2	[呵](又音，應答聲，表驚訝)
hɔ̃3	火=(激~:上火)
hɔ̃4	[呵](又音,嘆詞)
hɔ̃5	好(呼到切，喜~)
ɔ̃1	[捂](哄小孩睡覺的聲音)
ɔ̃2	□(~~:兒語，睡覺)
ɔ̃5	惡(烏路切，可~)

ẽ
be1	[嗎](哭切)
be2	[妹](~~:小女)
lẽ1	奶(又音，~~:兒語，乳汁)
hẽ1	兮(嘆詞，表示應諾)

iũ
biũ5	謬-	
tiũ1	張-(姓)
tiũ2	場-(操~)
tiũ3	長-(知丈切，隊~	)
tiũ4	丈-(又音，姊~:姐丈)
tiũ5	帳-(蠓~:蚊帳)脹-(~大)漲-(~水)
liũ1	妞-(~~，縮手縮腳，不大方)
liũ2	量-(呂張切,~布)糧-(~食)娘-(又音，~仔:蠶)梁(姓)樑(中~:大樑)梁(中~:大樑)涼-(~傘)
liũ3	兩-(又音，量詞:一~)
liũ5	讓-量-(力讓切，大~:大秤)	
tsiũ1	章-(文~)樟-漿-(豆~)
tsiũ2	裳-(衣~)
tsiũ3	蔣-(姓)槳-
tsiũ4	癢-上-(~學)	
tsiũ5	醬-(~瓜	)
tsʰiũ1	槍-(紅纓~)
tsʰiũ2	牆-薔-楊-(又音，~梅)
tsʰiũ3	廠-搶-	-
tsʰiũ4	象-(~牙)橡-(~奶:橡膠)像-(親~:相像)上-(又音,~水:汲水)	
tsʰiũ5	唱-(~歌)匠-(木~)
siũl箱-傷-(~鹹:太鹹)相-(息良又切，~思病)
siũ2	瘍-(粘液;髒)
siũ3	賞-
siũ4	想-
siũ5	相-(息亮切，十二生~:十二生肖)
kiũ1	薑-韁-
kiũ2	強-(~過:勝過，贏過)
kiũ4	強-(棍~:掙扎)
kʰiũ腔-（又音）姜-
hiũ1	香-(~火)鄉-
hiũ3	響-(又音	)
hiũ5	向-(又音，那樣)
iũ1	鴦-(鴛~)秧-(又音，白菜~:白菜苗)
iũ2	羊-洋-烊-熔-溶-楊-揚-(又音)陽-(洛~:地名)
iũ3	養-(~母:奶媽)
iũ5	樣(~品)

uĩ
puĩ2	爿-(柴~:木塊)
puĩ3	反（翻也）
pʰuĩ5	佩(~性命:拼命)
buĩ2	梅=煤䗋媒=(~妁)枚
buĩ3	每
buĩ5	妹=
tuĩ2	墊-(又音,門~:門檻)
tuĩ5	店-橂-(質地堅硬也)
tʰuĩ3	睇-(~燈:觀燈）
luĩ2	蓮-(~花)
luĩ3	捻-（碾壓）
luĩ5	荔-(~枝)
tsuĩ2	 前-(又音，~面)
tsuĩ3	 指-(又音，尾~仔:無名指）
tsʰuĩl 千-(又音，幾~)清-(又音，~明)
tsʰuĩ3	 筅-(雞毛~:雞毛撣子）喘-(噗噗~:心眺不停)
suĩ1	先-(~去)
kuĩ1	關-(~門)閒-(古閒切，一~)
kuĩ2	懸-(高也)
kuĩ3	柬-(選擇)
kuĩ5	縣-慣-(~勢:習慣）
kʰuĩ5	 快-(又音，~活)
guĩ2	龍-(~眼)
guĩ3	研-(~究)
huĩ2	橫-(~直:橫豎）
huĩ4	莧-(~菜)
huĩ5	衒(分饋)惠(又音，~安:地名)
uĩ2	閒-(無~:沒有時間)
uĩ3	偎-(又音，靠近，挨近)


ãi
pãi1	□(哭~:糟糕)
bãi1	糜-(又音，乾、稀飯的總稱)
bãi3	買=
bãi5	賣=邁
tãi2	[咍](~~~:小鑼音)
lãi3	乃奶=嬭=
lãi5	耐
tsãi	怎-(~樣)
tsʰãi3	□	(𣍐乃~:要不得)
hãi1	哼-(又音，~~呻:呻吟)
ãi	唉-(又音)

uãi
uãi1	彎-(~儂：騙人)

iãu
liãu1	貓-
liãu3	鳥
giãu1	蟯=(又音,搔癢) 
iãu1	貓-(又音)

ĩʔ
bĩʔ7	物-（什麼）
lĩʔ7	鑷-𥍉-(眨也)躡-
lĩʔ8	捏-
sĩʔ7	閃-(金𥍉~:金閃閃)
ĩʔ7	[嚶](芳~~:香噴嘵)

uĩʔ
buĩʔ7	蜢-(艸~:螞蚱)

ãʔ
lãʔ7	[凹]癟也
sãʔ7	□(抱也	)
hãʔ7	暍(熱氣或味道逼人)
hãʔ8	合-(~~:口頭上答應)


iãʔ
liãʔ7	□(目珠~起來:眼睛睜開)
hiãʔ7	□(~衫:持衣)
iãʔ7	[贏]背負也


ãiʔ
tãiʔ7	□(一~仔:一點兒)
hãiʔ7	[嗐](免~:別後悔)
ãiʔ8	[唉](𣍐~:不會哭叫)

uãiʔ
suãiʔ8	□(鋸)
kʰuãiʔ8	□(齩喫)
uãiʔ7	[𢺯](使勁搖晃	)

ãuʔ
bãuʔ7	[耆](阿~:無牙的人)
lãuʔ7	□(大口齩)
sãuʔ7		□(芋頭等不鬆)
sãuʔ8	□(嘮叨	)
gãuʔ7		□(晃動)
gãuʔ8	[嗷](~~吼:嘈雜亂叫)
hãuʔ7	[嗀](剝落	)
ãuʔ8	□(蝦蟆等叫)


iãuʔ
giãuʔ8	[蟯](𣍐~:不會蠕動)
hiãuʔ8	[蟯](又音，~~動:動箇不停)

ɔ̃ʔ
bɔ̃ʔ7	瘼-(老~~:人老而乾癟)膜-(緊貼)
bɔ̃ʔ8	膜-(又音)
sɔ̃ʔ8	□(貌~:難堪)

ẽʔ
bẽʔ7	咩(羊~~:羊)羋(羊~~:羊)
hẽʔ7	□(~過力:用力過度)
ẽʔ8	[唉](又音，~~吼:哭聲)

iũʔ
hiũʔ	[懩](~~:心裏癢癢)

iʔ
piʔ7	鼈襒(挽也)
pʰiʔ7	𠟈(薄薄地削)
biʔ7	覕(~起來:藏起來)
biʔ8	篾-(竹~）
tiʔ7	滴-
tiʔ	8	碟-挃(要)
tʰiʔ7	鐵剃(又音)
liʔ	7	[戾](~恝:乖張)
liʔ8	裂-(~開)
tsiʔ7	接-摺-(~衫褲:疊衣服)折-(旨熱切，存~)寂-(靜~~:寂靜)咫叱(~切:閃電)
tsiʔ8	舌-折-(常列切，斷)
tsʰiʔ7	[切](~掣:閃電)
tsʰiʔ8	蠘(一種螃蟹)
siʔ7	薛-(姓)
siʔ8	蝕-(~本)
kiʔ8	□	(驚叫)
kʰiʔ7	缺-(~喙:豁觜)
kʰiʔ8	□(粘住	)
hiʔ7	[嬉](~娎:不實在)
hiʔ8	[嘻](笑~~)
iʔ7	[踦](幼兒站立	)
iʔ8	[胰](肥皂)□	（稠）

uʔ
puʔ7	發-(冒出，長出)
puʔ8	[哱](𩟗啤~:味道很淡)
pʰuʔ7	[撲](罵人的話)哱(用氣吹)
pʰuʔ8	浡(泛~:水腫)
buʔ7	□(抽煙	)
buʔ8	[𢷕](用棍子打)
tuʔ7	厾(~頭:點頭)
tuʔ8	揬(搠也)
tʰuʔ7	托-
tʰuʔ8	[揬](癡也)
luʔ7	𨁸(~骹:跛腳)
tsuʔ7	[跓]暫停
tsʰuʔ7	[擉]輕觸
suʔ7	[欶]吮吸
kuʔ8		□(大口欱)
kʰuʔ7	[局](暫住，歇腳)
kʰuʔ8	汩(~糜:熬粥)
huʔ7	□(獨得，包攬	)
uʔ7	[煦](燒~~:暖烘烘)

ɯʔ
tsɯʔ7	[漬](以物蘸吸)
tsʰɯʔ7	[䟙](向前跌倒)
kɯʔ7	[鋸](澀~~:很澀)
kʰɯʔ7	[缺](一~:一成)

aʔ
paʔ7	百-
pʰaʔ7	拍-
baʔ7	脈-(肉也	)
baʔ8	覓-(~頭路:找工作)
taʔ7	答-(~應)搭-
taʔ8	踏-蹋-
tʰaʔ7	塔-獺-(~窟:地名)
tʰaʔ8	遝-(一~:一疊)沓-(一~:一疊)
laʔ7	[焟](~燥:略於)
laʔ8	蠟-臘-獵-曆-(~日:日曆)
tsaʔ7	紮(贊助，幫助)
tsaʔ8	牐-截-(~車)鍘-昨-(又音，~日:昨天)
tsʰaʔ7	插(~秧)
saʔ8	煠(白水煮物	)
kaʔ7	甲-胛-䘥-(~仔:背心)夾-(~肥脈:加帶一塊肥肉)合-(《集韻》葛合切，~意:中意)
kaʔ8	□	(高擧;拿)
kʰaʔ7	恰-(更、再)喀-卡-咔-較-(又音)
kʰaʔ8	屐-(柴~:木屐)
haʔ7	哈-(又音	)
haʔ8	合-(侯閣切，有~:合適)
aʔ7	押-鴨-壓-益-(~母艸)
aʔ8	匣-盒-

iaʔ
piaʔ7	壁-
pʰiaʔ7	辟-(躲避)僻-(~靜)癖-(習慣	)
pʰiaʔ8	癖-(又音，麻疹)
tiaʔ7	摘-(~菜)
tiaʔ8	糴-
tʰiaʔ7	拆-
liaʔ7	跡-(血~)
liaʔ8	掠-(~儂:抓人)
tsiaʔ7	隻(量詞:一~)跡-(又音，骹~:腳印)脊-(巴~:後背)則-(副詞,才)雀-(~仔:麻雀)睫-(目~毛:睫毛)
tsiaʔ8	食(喫也)
tsʰiaʔ7	赤-刺-(~羊毛衫:打毛衣)
tsʰiaʔ8	[斜](歪斜;拐道)
siaʔ7	削-(剁~)
siaʔ8	勺-(一~)石-(又音，~硯)
kʰiaʔ7	隙-(縫也)
giaʔ8	額-(超~)
hiaʔ8	額-(又音，頭~:額頭)
iaʔ7	挖-(~塗:挖土)益-(又音)
iap8	頁-役-(雜~)蝶-易-(~經)驛-

uaʔ
puaʔ7	缽-撥-
puaʔ8	跋-(~倒:摔倒)
pʰuaʔ7	潑-(~水)
pʰuaʔ8	□(盤繞，披掛)
buaʔ7	抹-
buaʔ	8	末-沫-
tuaʔ7	掇-(張~:賭氣)
tʰuaʔ7	屜-獺-(又音，水~)
luaʔ7	捋-(訓斥)
luaʔ	辣-捋-(又音，~頭毛:梳頭髮)熱-(~天)
tsuaʔ7	泄-(搖曳)[拙](~好:這麼好)
tsuaʔ1	蚤-(虼~:蟑螂)
tsʰuaʔ7	泄-(又音，~尿:尿禁不住而泄出)掣(發抖;猛拉)礤(菜~:礤牀)
tsʰuaʔ8	𪘧(不正也)
suaʔ7	煞-(~尾:結束)刷-撒-(~鹽)殺-
kuaʔ7	割-刮-(~風)括-(一~:一夥)葛(番~:涼薯)
kʰuaʔ7	闊(~喙:大嘴巴)渴(喙凋喉~:口渴)
huaʔ7	喝-？-赫-(~大:那麼大)
huaʔ	8	伐-(大~:大步)
uaʔ8	活-

auʔ
pauʔ7	暴-(~牙:齙牙)
pauʔ8	[包](全部買下)
pʰauʔ7	鞄(嬰仔真~:嬰兒很胖)
tauʔ7	篤-(模~:質地堅硬)罩-(老鼠~:捕鼠器)
tauʔ8	沓-(又音，~~來:常常來)瀆-(洘~~:稠糊)
lauʔ7	落-(~臉:丟臉)
lauʔ8	落-(又音，揭~:掉落)
tsʰauʔ7	[蓸](茹~~:亂糟槽)
tsʰauʔ8	[漕](~~滴:滴箇不停)
kauʔ7	瀔(~肥:漚肥)
kauʔ8	轂(軟~~:耎綿綿)
kʰauʔ7	銬(又音,~去:銬走)
kʰauʔ8	瓽(~飲糜:熬粥)
auʔ7	拗(又音，~紙:折紙)

iauʔ
liauʔ7	□(女性不實在)
liauʔ8	□(~溝:平整壟溝)
tsiauʔ7	悄(~~)
tsʰiauʔ8	嚼-(好說話)
kiauʔ7	攪-(又音，以針挑)
kʰiauʔ7	□(死)
giauʔ7	撓(打鉤)
hiauʔ7	娎(嬉~:舉止輕浮)

ɔʔ
ɔʔ8	嘔-

oʔ
poʔ7	博-(沒有把握的嘗試)搏-(拼~)
poʔ8	薄-(厚~)泊-(落~:落魄)
pʰoʔ7	粕-(糟~)
boʔ7	膜-(又音，~壁:緊貼牆壁)[卜]要也
boʔ8	膜-(又音，竹~)
toʔ7	桌-卓-
toʔ8	著-(~火:火燃)
tʰoʔ8	踱-(天~:愛理不理)
loʔ8	落-(又音，~雨)洛-(~陽橋:橋名)
tsoʔ7	作-(~穡:做工)
tsoʔ8	踖(征~:四處奔走)昨-(又音，~日:大前天)
tsʰoʔ7	戳-(~儂:罵人)
soʔ7	索紙索
soʔ8	鐲-□(狹小)
koʔ7	各-閣-佫-(再也)胳-廓-
hoʔ7	□	(在水中久煮)
hoʔ8	鶴-
oʔ7	惡(難也)
oʔ8	學(~堂:學校)

ioʔ
tioʔ7	擢-(拉，提)
tioʔ8	著-(又音，~火燒:著火)
1	ioʔ7	瞭-(眼斜視)
lioʔ8	略-(惜~:愛惜東西)
tsioʔ7	借-
tsioʔ8	石-(又音，~頭)
tsʰioʔ7	尺-(一~)螫(蟲~著:蟲齩)
tsioʔ8	席-(艸~)
sioʔ7	惜-(愛~)
sioʔ8	俗-(平淡乏味)液-(手~:手上的汗)芍-
kioʔ7	腳(腳色	)
kʰioʔ7	抾(拾取)[拾]拾取
gioʔ8	[謔](譏諷，挑逗)
hioʔ7	歇(~睏:休息)
hioʔ8	箬-(葉也)諾-(表同意的應答聲)鶚-(老~:老鷹)
ioʔ7	溢-(搖動，搖晃)約-(估計)
ioʔ8	-藥-鑰-(門~咧:門鎖著)

əʔ
pəʔ7	[𤴭](小兒驚風)
pʰəʔ8	垡-(泡沫)
bəʔ7	[卜](又音，要也)
bəʔ8	韤
təʔ7	啄-(~米)
təʔ8	奪-
tʰəʔ8	摕(拿也)
ləʔ7	□(用手指捏取)
tsəʔ7	㿱(~脫:糟蹋)
tsəʔ8	絕-
tsʰəʔ啜(~糜:喫粥)
səʔ7	雪-說-(失爇切)刷-(又音，漆~)
səʔ8	踅-(轉圈子)
kəʔ7	郭-
kʰəʔ7	缺-(又音，欠缺)
kəʔ1	□(驚~~:害怕)
gəʔ月-(~亮)
həʔ7	豁-(~性:因受激將而下決心)
əʔ7	噁-(~酸水:吐酸水)呃
əʔ8	呃(應~:打嗝)


eʔ
peʔ7	𧻙	(爬也)伯-柏-擘-(~幵:掰開)檗-
peʔ8	白-(~色)帛-(骹~:裹腳布)
beʔ8	麥-
teʔ7	硩-(壓也	)
teʔ8	硩-(又音，平息)
tʰeʔ7	徹(~~:光溜溜〉
tʰeʔ8	宅-(處~：房屋)
leʔ7	□(過秤時重量略欠)
leʔ8	裂-
tseʔ7	仄-(平~)
tsʰeʔ7	冊-(讀~:讀書)砌-
tsʰeʔ8	鑔-(小鈸)
seʔ7	□(掉落)
keʔ7	格-(方~)膈-(~食)隔-(~壁	)
keʔ8	桀-(阻止、阻擋)
kʰeʔ7	客-
kʰeʔ8	桀-(又音，~~:隔閡)
heʔ7	嚇
eʔ8	[穢]髒

ueʔ
pueʔ7	八-(~十)
pueʔ	8	拔-
tʰueʔ7	替-(又音，鞋~:鞋墊子)
tʰueʔ8	摕(又音，拿也)
lueʔ7	[哷]苟延殘喘
lueʔ8	笠-
tsueʔ7	節-(~季:季節)
tsueʔ8	截-(又音，切也)
tsʰueʔ7	切-(又音，千結切，小聲哭泣)
sueʔ7	揳-(塞也)
kueʔ7	鍥(~仔:割艸刀)
kueʔ8	挾-狹-(勼勼~~:局促)
kʰueʔ7	鍥(擠也)瞎-(~目:閉下眼睛)
kʰueʔ8	挈(儂~:沒出息的人)狹-(又音，狹縫)
gueʔ7	筴(~菜:夾菜)莢-（豆~）
gueʔ8	[挾]
hueʔ7	𥄎(眨眼)
ueʔ8	劃-(~一痕:畫1	道)狹-(又音背,窄也)

mʔ

hmʔ7	□(使勁打)
hmʔ8	嘿-(~~:不作聲)默-(~~:不作聲)
mʔ8	無-(嘆詞，表示疑惑)

ŋʔ
pŋʔ8	[彭]跌落
pʰŋʔ8	[𢵓]使勁打
byʔ7	物-(又音，~繏:東西)
bŋʔ8	物-(又音，~件:東西)
tŋʔ8	□(說話吞吞吐吐或結結巴巴)
tʰŋʔ8	團-(量詞:一~羊毛)
tsŋʔ8	旋-(糾纏不肯離去)
tsʰŋʔ7	[嗆](~喉:異物進入呼吸道)
tsʰŋʔ8	蹭-(磨磨蹭蹭)
sŋʔ7	[繏](勒緊繩子)
sŋʔ8	2	[嗆](吸進鼻涕)
kŋʔ8	□(握也	)
ŋʔ8	嗯-(應聲)

iuʔ
piuʔ7	[𬧌](裂開)
piuʔ	8	[滮](內胎一類東西破裂，	氣體或液體外泄)
pʰiuʔ8	[猋](滑脫，溜走)
tiuʔ7	搐-(衫~直:把衣服拉直)擢-(~升)
liuʔ7	[溜](掉下來)
tsiuʔ7	[喌](密~~：很嚴密)
tsiuʔ8	啾(鳥鳴)
tsʰiuʔ7	觸-(~著鬼:碰上鬼)
tsʰiuʔ8	□(濺也)
siuʔ	[泅]呷也
kiuʔ7	掬(抽縮)
kiuʔ8	趨(軟~~:軟綿綿)
kʰiuʔ7	□死也
hiuʔ8	□(吸氣)


uiʔ
pʰuiʔ7	[呸](一~仔:小不點兒)
tʰuiʔ8	□(沈，重)
kuiʔ7	刮-(又音，抹也	)
guiʔ7	刮-(又音，抹也)
huiʔ7	血-(~管)
uiʔ7	挖-(又音，~塗:挖土)
uiʔ8	劃(又音，縫合處裂開)

ip
tip8	蟄=(~伏)
lip7	□(稍欠)
lip8	入立(~正)粒=
tsip7	執(追也)緝輯=汁
tsip8	集寂-(又音，~靜)籍
tsʰip7	緝(又音)輯(又音)楫
sip7	濕=溼=澀=
sip8	習=十=什=拾=(收~)襲
kip7	急給(供~)汲
kip8	及(~格)
kʰip7	吸-(呼~)汲(又音)
kʰip8	及(又音，緊緊抓住)
hip7	翕=(~像:照相)熻(~飯:燜飯)吸=
ip7	揖(作~)


ap
tap7	答=(問~)搭=
tap8	踏=
tʰap7	榻塌=蹋
tʰap8	遝=(紛至~來)
lap7	塌-(塌下去)鈉(踹也	)
lap8	納(~稅)衲
tsap7
tsap8	十-什-拾-雜牐=
tsʰap7	插=(~牌:洗牌)
sap7	圾-(垃~)[屑](~~:有沙粒狀的口感)
sap8	𩆅(雨~~:雨點很密)牐=(又音)
kap7	合=(《集韻》葛合切，~藥:配藥)鴿夾=(照管也)甲=(~第)
kap8	洽-(液休稠)
kʰap7	恰=(~當)卡=咔-
kʰap8	磕=(~破:碰破)
hap7	[哈](又音，~一喙:張開大口喫一口東西)翕-(又音，~像:照相)
hap8	合=(侯閣切，聯~)盒=匣=狹=峽=
ap7	壓=(鎮~)押=鴨=
ap8	盒=

iap
tiap7	輒
tiap8	蝶=(蝴~)諜牒疊(重~)
tʰiap7	帖貼
tʰiap8	疊(又音，~羅漢)
liap7	聶(姓)懾攝躡=鑷=囁=涅捏=(~造)
liap8	粒-
tsiap7	接=(~應)睫=
tsiap1	捷-(快也)
tsʰiap7	妾竊
siap7	澀-(生~)
siap8	涉[泄](~尿:小便失禁)
kiap7	劫夾-(又音)袂狹(又音)峽俠挾-莢=
kʰiap7	㾀(身體不舒服)怯(膽~)
giap7	夾-(又音)挾-(又音)
giap1	業
hiap1	協脅挾=(要~)狹-(~義)峽-俠(又音)洽-(又音，接~)
iap7	挹(藏也)
iap1	葉(姓)頁=

it
pit7	畢筆必鼻=
pit8	弼帛=
pʰit7	匹疋
bit2	蜜密=(機~)
tit7	得-的-(目~)
tit	直值=(~日)侄
tʰit7	佚-(~侘:玩耍)
lit8	日栗=
tsit7	質即-鯽責-幟=積-績織脊-(處~:屋脊)
tsit8	疾[一]蜀-
tsʰit7	七=柒=拭-(~桌:擦桌子)漆=
sit7	失熄-穡-(作~:幹活兒)
sit8	席(主~)席=（藉也）食=(~品)翼-(翅膀)石=殖植蝕=
kit7	乞
kʰit8	􂳅(木柱，木釘)
hit7	迄(指示代詞，那)
hit8	𦑌(在空中搖盪）
it7	乙一=
it8	佚=軼佾逸=

ut
put7	柫-(~塗:扒土)不
put8	佛-(~公:菩薩)勃-渤
pʰut8	□(蹦，跳)
but7	勿(暢~~:很高興)
but8	勿(又音)物=(人~)𢪥(鞭打)
tut8	突(~擊)
tʰut7	黜=(罷免)脫-(~臼	)
tʰut8	禿
lut7	黜-(~職:降職)脫-(又音，~衫褲:脫衣服)
lut8	律率(效~)捋=(~手骨:捋胳膊)
tsut7	卒(兵~)
tsut8	朮(白~:藥名)秫-(~米:糯米)
tsʰut7	出-
sut7	戌[瞬](~~目:眨限)屑-(又音，鋸~:鋸末)率(~領)[摔](抽打)蟀(做~)恤(撫~金)
sut8	術=秫=述術(美~	)
kut7	骨
kut8	滑-猾-(狡~)掘(刨挖)
kʰut7	屈倔窟
kʰut8	𣮈(大~:大氅)
gut7	迄(又音，~今)
gut8	兀
hut7	弗彿拂佛(敷勿切，仿~)忽柫=
hut8	核=(量詞，一~:一顆)佛=(~法)
ut7	鬱尉(姓)熨兀(又音)
ut8	[聿](隨便寫一下)


at
pat7	八=(三~婦女節)捌=
pat8	別(~儂:別人)
bat8	密-墨-(~賊:烏賊魚)
tat7	□(𣍐度~咧:不像樣)
tat8	值-(價~)達笛-
tʰat7	踢-剔-塞-
lat7	□(~遢：不講衛生,不修邊幅)
lat8	力-栗-辣=
tsat7	紮=節-(又音，一~)
tsat8	實-(~心)賊-(墨~:烏賊魚)鍘=
tsʰat7	察擦漆-
tsʰat8	賊-(又音，~仔:小偷)
sat]	殺=刹蝨(木~:臭蟲)薩(菩~)塞=撒=
kat7	葛=結=(~索:結繩子)割=
kʰat7	[刻](石~:石階)克-(~苦:忍受)渴=
hat7	轄喝=暍=
hat8	核-(又音，牽~:淋巴結)乏-(東西少)
at7	扼(扳也)遏(~制)
at8	□(倒液體時擋住渣滓或泡的東西的動作)

iat
piat7	鱉=䘷=
piat8	別=(區~)
pʰiat7	撇=(碟子)撇=瞥=
pʰiat8	□(劈也)
biat8	滅蔑(~視)
tiat7	哲(~學)
tiat8	秩(~序)
tʰiat7	徹=沏(清~)撤鐵=(~面無私)
liat8	列烈裂=(分~)熱=(~烈	)
tsiat7	節=(~約)癤=折(旨熱切)浙即=(~使)
tsiat8	截=捷=(~報)
tsʰiat7	切=(千結切，~身)砌=
siat7	設泄=(~露)屑=
siat8	舌=(口~)折=(常列切)
kiat7	吉潔桔結=(團~)
kiat8	傑桀=(姓)竭=(~力)
kʰiat7	揭(~發)恝(戾~:乖張)
kʰiat8	竭=(又音，儂~~:人很瘦小)桀=(又音，乖戾)
giat7	蝎-(龍蝦前面雙肢鉗物的動作)
giat8	孽(頑皮	)
hiat7	血=(~淚)歇=(宿~:歇宿)蠍=
hiat8	穴
iat7	謁(~見)悅-閱-(~讀)
iat8	曳(招展，揮動)


uat
puat7	缽=撥=
puat8	拔=(提~)跋=
pʰuat7	潑=(活~)撇=(又音,一~)
buat7	抹=
buat8	末=(~朝)沫=沒(沈~)
tuat7	綴(《集韻》襪劣切，點~)
tuat8	奪=(爭~)
tʰuat7	脫=(~身)
luat8	劣
tsuat7	拙撮(~要)
tsuat8	絕=(~對)
tsʰuat7	撮(又音)啜=率(又音)
suat7	說=(失費切，小~)雪=(又音，~領)刷=(又音，白~~)
suat8	踅=
kuat7	決抉(~粉:塗粉)括=(包~)	刮(~灰:抹灰)
kʰuat7	缺=(~席)厥闕
kʰuat8	□(用力攪拌)
guat8	月=(明~)
huat7	發=法豁=
huat8	罰伐=垡=閥乏=(缺~)活=(生~)猾=滑=
uat7	挖=斡(~彎:拐彎)曰悅=閱=
uat8	越粵

ak
pak7	剝=(~奪)駁-北-腹-(~肚:肚子)幅-(一~布)
pak8	縛-(~儂:捆人)
pʰak7	僕-(伏也)撲-樸-覆-(倒翻)
pʰak8	曝-(~衫:曬衣服)
bak7	毣(~水:霑水)
bak8	墨-(又音，~水)木-沐-目-(~珠:眼睛)
tak7	豛(牛~:牛打架)
tak8	逐-(~日:每天)毒-(又音)擢=
tʰak7	𢬳(~算盤:打算盤)
tʰak8	讀-(~書)
lak7	落-(又音，~去:東西丟失)
lak8	六-陸-搦-(用手指抓物)
tsak7	則=(原~)齪-(齷~)
tsak8	促-(著加~:嗆)賊=
tsʰak7	測-側-𢄧-(條幅)簇-
tsʰak8	鑿-戳-
sak7	捒(抱搡)索-(~性:乾脆)
kak7	角桷(~仔：檁條)覺穀-？-谷-？-菊-
kak8	□(祛~:喻人或事敗壞到不可收拾)
kʰak7	麯-殼-確
gak1	岳獄樂(五角切，音~)
hak7	□(~酒:釀酒)
hak8	學=(~問)礐(廁所)
ak7	沃-(~雨:淋雨)握=(把~)幄齷=

iak
piak7	迫逼=煏(~火:烤火)百=伯=柏=濼(梁山~)檗=擘=
piak8	白=(明~)
pʰiak7	辟=霹癖=僻=闢劈拍=泊?(又音)魄碧
pʰiak8	擗(摑	;鞭打	)
biak8	墨=嘿=(~寫)默=(~寫)覓=
tiak7	竹-德得=(心~)摘=嫡(~系)的=(~確)
tiak8	敵狄(姓)軸-笛=澤擇擢=(~	升)特蟄-(驚~)
tʰiak7	惕剔=踢=㜅-(漂亮)
liak7	慄(昏倒)勒(~令)肋(~骨)
liak1	力=曆=(~法)綠-
tsiak7	燭-責=(追問，責問)脊=(~梁)叔-寂跡(形~)積=借=即=(又音，立~)
tsʰiak8	賊=
tsʰiak7	策測=側=廁=戚粟(稻子)赤=(~身裸體)尺=(~牘)促-(~垛:縮短)冊=(~封)七-柒-
tsʰiak8	蹙(~布袋:抖布袋)
siak7	室色識式拭=飾適塞=(又音)背惜=錫悉息媳熄=宿-(成熟)析皙(白~~:白花花)穡=
siak8	熟-(成~)石=
kiak7	擊激(~氣:擺架子)革格=(列寧~勒:地名)
kiak8	極局-劇-(~烈)
kʰiak7	刻=(時~)克=曲-隙=
kʰiak8	咯-(~紅:咯血)屐=
giak8	玉-逆
hiak7	黑嚇=(恐~)赫-(~然)
hiak	或(~者)域-(區~)惑(迷~)劃=(計~)肉-獲=(~得)
iak7	益=溢億憶抑(~制)域=
iak8	譯易=(又音,交~)液=役疫逸-	(勞~結合)亦=(~然)

ɔk
pɔk7	駁=(反~)卜(占~)泊=(飄~)暴=(目珠~出來:眼睛突出)北=剝-搏=
pɔk8	縛=(束~)薄=(刻~)暴=(又音,~動)
pʰɔk7	博=撲=僕=樸=璞粕=搏=(又音 脈~)
pʰɔk8	曝=(一~十寒)噗(拍~仔:鼓掌	)
bɔk7	沐=(大口欱;掉下，陷入)
bɔk8	莫膜=(頂禮~拜)瘼=寞木=沐=(又音，~浴)目=穆牧睦
tɔk7	督篤=啄=椓(以物擊物)卓=厾=(輕擊)
tɔk8	毒=(狠~)獨鐸瀆=(~職)擢=(又音)
tʰɔk7	托=託
tʰɔk8	讀=牘(尺~)
lɔk7	漉(~水:涉水)簏(紙~:紙袋)
lɔk8	=洛=落=(~後)駱絡樂(盧各切，快~)鹿=諾(~言)
tsɔk7	作=(工~)
tsɔk8	族昨=
tsʰɔk7	簇=齪=
tsʰɔk	8	戳=鑿=
sɔk7	束速朔索=宿=
sɔk8	□(吞，喫	)
kɔk7	各=佫=閣=胳=谷=？=穀=?=郭=國
kɔk8	[汩](大口地欱)
kʰɔk7	酷(殘~)擴哭=殼=[簏](火擦~:火柴盒)廓=
kʰɔk8	[汩](又音，久煮)
gɔk8	鱷(~魚)鶚=
hɔk7	褔幅=(~射)蝠(蝙~)霍複腹=(~)
hɔk8	服伏(埋~)復(收~)鶴=
ɔk7	惡(烏各切，~霸)僫=屋齷=沃=(肥~)

iɔk
tiɔk7	築竹=(絲~)
tiɔk8	著=(沈~)逐=(驅~)軸=
tʰiɔk7	畜(~生)蓄(積~)㜅=搐=
liɔk8	六-(~一兒童節)肉=虐-辱陸=略=(戰~)掠=若=（~干）諾=(又音)箬=弱祿綠=
tsiɔk7	祝足燭=爵鐲=
tsiɔk8	嚼=芍(~藥)
tsʰiɔk7	促=(~進)捉(~拿)觸=(~電)[撮](一小~)雀=(孔~)
tsʰiɔk8	浞(~塗糜:搗爛泥)躍-(跳)
siɔk7	叔=淑宿=(又音,~舍)縮(壓~)粟=削=(切~)
siɔk8	俗=(風~)贖續=(繼~)蜀熟=勺=芍=
kiɔk7	菊=鞠
kiɔk8	局=劇=(戲~	)
kʰiɔk7	卻=曲=(~折)
giɔk7	□(喫)
giɔk8	玉=(~石)虐=(暴~)
hiɔk7	旭
iɔk7	約=(節~)
iɔk8	育欲浴=躍=鑰=藥=(芍~)







